STATE,COUNTY,fips,STNAME,CTYNAME,WA_MALE,WA_FEMALE,BA_MALE,BA_FEMALE,AA_MALE,AA_FEMALE,H_MALE,H_FEMALE,white_pop,asian_pop,black_pop,hisp_pop
1,1,1001,Alabama,Autauga County,20878,21729,5237,6000,286,370,884,787,42607,572,10474,1671
1,3,1003,Alabama,Baldwin County,94810,100388,9486,10107,932,1448,5545,4989,195198,1864,18972,10534
1,5,1005,Alabama,Barbour County,6389,5745,6311,5595,55,61,629,488,12134,110,12622,1117
1,7,1007,Alabama,Bibb County,8766,8425,2941,1822,23,25,343,280,17191,46,5882,623
1,9,1009,Alabama,Blount County,27258,28154,516,462,85,100,2950,2632,55412,170,1032,5582
1,11,1011,Alabama,Bullock County,1629,1060,3713,3384,9,12,449,415,2689,18,7426,864
1,13,1013,Alabama,Butler County,4829,5298,3885,4862,168,111,153,136,10127,336,7770,289
1,15,1015,Alabama,Calhoun County,41342,43980,11220,12993,401,623,2358,2256,85322,802,22440,4614
1,17,1017,Alabama,Chambers County,9157,9813,6221,7144,240,134,472,399,18970,480,12442,871
1,19,1019,Alabama,Cherokee County,12033,12376,558,515,37,66,229,220,24409,74,1116,449
1,21,1021,Alabama,Chilton County,18965,19712,2247,2349,87,130,1990,1646,38677,174,4494,3636
1,23,1023,Alabama,Choctaw County,3499,3692,2370,2885,7,18,55,73,7191,14,4740,128
1,25,1025,Alabama,Clarke County,6057,6461,4878,5757,46,57,162,148,12518,92,9756,310
1,27,1027,Alabama,Clay County,5400,5615,867,957,19,19,231,204,11015,38,1734,435
1,29,1029,Alabama,Cleburne County,6999,7177,193,231,10,23,212,175,14176,20,386,387
1,31,1031,Alabama,Coffee County,19647,20022,4429,4787,320,558,2189,1982,39669,640,8858,4171
1,33,1033,Alabama,Colbert County,21424,23016,4108,4851,152,222,925,864,44440,304,8216,1789
1,35,1035,Alabama,Conecuh County,3103,3142,2524,3036,11,17,150,127,6245,22,5048,277
1,37,1037,Alabama,Coosa County,3604,3514,1606,1688,6,12,152,128,7118,12,3212,280
1,39,1039,Alabama,Covington County,15234,16077,2138,2500,90,96,342,345,31311,180,4276,687
1,41,1041,Alabama,Crenshaw County,4895,5044,1509,1780,80,72,185,148,9939,160,3018,333
1,43,1043,Alabama,Cullman County,39626,40562,635,521,224,383,1924,1828,80188,448,1270,3752
1,45,1045,Alabama,Dale County,18256,18017,4790,5524,251,462,1831,1619,36273,502,9580,3450
1,47,1047,Alabama,Dallas County,4910,5349,11940,14360,91,76,237,192,10259,182,23880,429
1,49,1049,Alabama,DeKalb County,32870,33433,688,652,199,172,5715,5059,66303,398,1376,10774
1,51,1051,Alabama,Elmore County,29676,31785,8345,8834,270,340,1289,1274,61461,540,16690,2563
1,53,1053,Alabama,Escambia County,11261,11554,5974,5476,53,69,530,422,22815,106,11948,952
1,55,1055,Alabama,Etowah County,40115,42386,7542,8560,412,429,2225,2005,82501,824,15084,4230
1,57,1057,Alabama,Fayette County,6817,7163,927,974,19,59,172,163,13980,38,1854,335
1,59,1059,Alabama,Franklin County,14388,14369,776,597,55,59,3153,2453,28757,110,1552,5606
1,61,1061,Alabama,Geneva County,11187,11708,1181,1264,44,48,584,511,22895,88,2362,1095
1,63,1063,Alabama,Greene County,735,765,3033,3449,11,12,73,66,1500,22,6066,139
1,65,1065,Alabama,Hale County,2956,3007,3909,4591,19,25,111,98,5963,38,7818,209
1,67,1067,Alabama,Henry County,5992,6323,2097,2357,33,40,239,224,12315,66,4194,463
1,69,1069,Alabama,Houston County,35314,37558,13435,15541,477,660,1920,1711,72872,954,26870,3631
1,71,1071,Alabama,Jackson County,23189,23984,893,910,132,169,832,752,47173,264,1786,1584
1,73,1073,Alabama,Jefferson County,169820,179696,130550,155711,5599,6187,14247,12626,349516,11198,261100,26873
1,75,1075,Alabama,Lamar County,5940,6143,673,753,7,8,145,118,12083,14,1346,263
1,77,1077,Alabama,Lauderdale County,38812,41821,4273,5016,359,399,1313,1339,80633,718,8546,2652
1,79,1079,Alabama,Lawrence County,12596,13161,1686,1896,33,40,403,376,25757,66,3372,779
1,81,1081,Alabama,Lee County,58022,58389,17413,20325,3614,3246,3217,2874,116411,7228,34826,6091
1,83,1083,Alabama,Limestone County,39932,40189,7118,6644,716,947,3133,3016,80121,1432,14236,6149
1,85,1085,Alabama,Lowndes County,1258,1269,3234,3809,24,23,85,96,2527,48,6468,181
1,87,1087,Alabama,Macon County,1579,1551,6442,8080,71,37,188,155,3130,142,12884,343
1,89,1089,Alabama,Madison County,128106,128722,43203,49506,4532,5446,9959,9393,256828,9064,86406,19352
1,91,1091,Alabama,Marengo County,4275,4518,4403,5335,25,32,275,253,8793,50,8806,528
1,93,1093,Alabama,Marion County,13657,14282,664,483,41,57,434,366,27939,82,1328,800
1,95,1095,Alabama,Marshall County,44023,45791,1766,1312,287,396,7706,6566,89814,574,3532,14272
1,97,1097,Alabama,Mobile County,118447,125398,68501,81208,3993,4566,6373,6070,243845,7986,137002,12443
1,99,1099,Alabama,Monroe County,5637,5840,3857,4639,51,45,165,182,11477,102,7714,347
1,101,1101,Alabama,Montgomery County,39387,41035,61404,72952,3607,3817,4344,4000,80422,7214,122808,8344
1,103,1103,Alabama,Morgan County,48936,50178,7537,8128,356,463,5660,4806,99114,712,15074,10466
1,105,1105,Alabama,Perry County,1305,1393,2764,3299,42,14,69,75,2698,84,5528,144
1,107,1107,Alabama,Pickens County,5985,5583,3798,4167,33,31,666,378,11568,66,7596,1044
1,109,1109,Alabama,Pike County,9410,9626,5714,6815,332,288,424,378,19036,664,11428,802
1,111,1111,Alabama,Randolph County,8724,8995,2060,2310,43,61,358,324,17719,86,4120,682
1,113,1113,Alabama,Russell County,14195,14751,12317,14047,183,329,1712,1666,28946,366,24634,3378
1,115,1115,Alabama,St. Clair County,38585,39724,4535,4115,374,429,1093,1092,78309,748,9070,2185
1,117,1117,Alabama,Shelby County,87513,92176,13458,15539,2202,2722,6469,6166,179689,4404,26916,12635
1,119,1119,Alabama,Sumter County,1517,1670,4026,4847,93,145,78,71,3187,186,8052,149
1,121,1121,Alabama,Talladega County,25080,26162,12244,14167,246,310,1112,801,51242,492,24488,1913
1,123,1123,Alabama,Tallapoosa County,13968,14504,5102,5799,104,132,558,463,28472,208,10204,1021
1,125,1125,Alabama,Tuscaloosa County,66468,67973,30731,37134,1721,1669,4421,3887,134441,3442,61462,8308
1,127,1127,Alabama,Walker County,28171,29589,1845,2089,174,190,923,758,57760,348,3690,1681
1,129,1129,Alabama,Washington County,5336,5440,1812,1992,153,34,138,126,10776,306,3624,264
1,131,1131,Alabama,Wilcox County,1418,1450,3433,3938,12,9,80,69,2868,24,6866,149
1,133,1133,Alabama,Winston County,11129,11533,132,104,30,55,413,368,22662,60,264,781
2,13,2013,Alaska,Aleutians East Borough,528,177,308,32,959,488,375,118,705,1918,616,493
2,16,2016,Alaska,Aleutians West Census Area,1381,531,352,46,1357,903,579,208,1912,2714,704,787
2,20,2020,Alaska,Anchorage Municipality,95659,88011,9191,8004,13161,15590,13854,13138,183670,26322,18382,26992
2,50,2050,Alaska,Bethel Census Area,1026,866,91,84,87,96,267,236,1892,174,182,503
2,60,2060,Alaska,Bristol Bay Borough,192,156,6,1,4,11,33,29,348,8,12,62
2,68,2068,Alaska,Denali Borough,962,777,27,16,61,52,45,35,1739,122,54,80
2,70,2070,Alaska,Dillingham Census Area,414,362,28,12,22,23,79,103,776,44,56,182
2,90,2090,Alaska,Fairbanks North Star Borough,39983,33247,2966,2182,1513,1770,4372,3566,73230,3026,5932,7938
2,100,2100,Alaska,Haines Borough,1020,998,9,6,4,18,41,50,2018,8,18,91
2,105,2105,Alaska,Hoonah-Angoon Census Area,539,510,41,6,13,8,62,66,1049,26,82,128
2,110,2110,Alaska,Juneau City and Borough,11265,10677,295,178,1029,1181,1168,1068,21942,2058,590,2236
2,122,2122,Alaska,Kenai Peninsula Borough,25597,23293,291,183,423,668,1307,1199,48890,846,582,2506
2,130,2130,Alaska,Ketchikan Gateway Borough,4877,4498,92,58,513,620,428,347,9375,1026,184,775
2,150,2150,Alaska,Kodiak Island Borough,3950,3193,113,56,1403,1449,619,504,7143,2806,226,1123
2,158,2158,Alaska,Kusilvak Census Area,162,151,69,9,20,16,154,95,313,40,138,249
2,164,2164,Alaska,Lake and Peninsula Borough,215,162,12,8,18,31,33,22,377,36,24,55
2,170,2170,Alaska,Matanuska-Susitna Borough,46699,42676,832,616,718,1154,2841,2772,89375,1436,1664,5613
2,180,2180,Alaska,Nome Census Area,859,710,45,41,89,58,139,149,1569,178,90,288
2,185,2185,Alaska,North Slope Borough,2576,636,109,52,315,224,277,149,3212,630,218,426
2,188,2188,Alaska,Northwest Arctic Borough,542,347,73,62,38,38,157,124,889,76,146,281
2,195,2195,Alaska,Petersburg Borough,1262,1179,44,14,47,74,114,74,2441,94,88,188
2,198,2198,Alaska,Prince of Wales-Hyder Census Area,1631,1252,28,10,31,46,135,106,2883,62,56,241
2,220,2220,Alaska,Sitka City and Borough,2854,2735,50,32,309,340,341,288,5589,618,100,629
2,230,2230,Alaska,Skagway Municipality,537,484,6,4,11,17,44,35,1021,22,12,79
2,240,2240,Alaska,Southeast Fairbanks Census Area,2955,2380,92,54,72,97,245,237,5335,144,184,482
2,261,2261,Alaska,Valdez-Cordova Census Area,3558,3084,48,46,247,220,252,266,6642,494,96,518
2,275,2275,Alaska,Wrangell City and Borough,906,815,10,5,39,40,42,34,1721,78,20,76
2,282,2282,Alaska,Yakutat City and Borough,124,77,11,1,20,15,16,11,201,40,22,27
2,290,2290,Alaska,Yukon-Koyukuk Census Area,678,553,24,27,4,25,87,77,1231,8,48,164
4,1,4001,Arizona,Apache County,8245,7768,204,200,174,171,2509,2227,16013,348,408,4736
4,3,4003,Arizona,Cochise County,55857,54608,3297,2379,1073,1771,22490,22498,110465,2146,6594,44988
4,5,4005,Arizona,Coconino County,47024,47295,1150,1030,1313,1633,10374,10168,94319,2626,2300,20542
4,7,4007,Arizona,Gila County,20982,21275,246,195,204,285,5184,5032,42257,408,492,10216
4,9,4009,Arizona,Graham County,17077,14638,555,175,150,138,7288,5591,31715,300,1110,12879
4,11,4011,Arizona,Greenlee County,4438,4122,112,90,30,49,2325,2201,8560,60,224,4526
4,12,4012,Arizona,La Paz County,8430,7754,139,115,86,105,3087,2895,16184,172,278,5982
4,13,4013,Arizona,Maricopa County,1839169,1874727,143502,142817,98196,109515,705642,703213,3713896,196392,287004,1408855
4,15,4015,Arizona,Mohave County,98480,96121,1794,1009,1044,1566,18903,17016,194601,2088,3588,35919
4,17,4017,Arizona,Navajo County,28597,27289,725,384,299,393,6995,5747,55886,598,1450,12742
4,19,4019,Arizona,Pima County,435968,452288,23690,20184,16392,18683,193953,201493,888256,32784,47380,395446
4,21,4021,Arizona,Pinal County,197681,184898,13533,11242,4289,4562,76954,65322,382579,8578,27066,142276
4,23,4023,Arizona,Santa Cruz County,21429,22971,236,224,172,197,18496,20215,44400,344,472,38711
4,25,4025,Arizona,Yavapai County,107131,112147,1203,921,1256,1689,17794,16847,219278,2512,2406,34641
4,27,4027,Arizona,Yuma County,99824,95209,3597,2049,1534,1754,69995,68136,195033,3068,7194,138131
5,1,5001,Arkansas,Arkansas County,6173,6376,2009,2378,67,77,335,267,12549,134,4018,602
5,3,5003,Arkansas,Ashley County,7098,7223,2222,2631,27,26,625,494,14321,54,4444,1119
5,5,5005,Arkansas,Baxter County,19641,20837,118,78,68,137,555,547,40478,136,236,1102
5,7,5007,Arkansas,Benton County,122143,124842,3059,2694,6331,5297,24376,23254,246985,12662,6118,47630
5,9,5009,Arkansas,Boone County,17661,18263,113,65,90,128,480,508,35924,180,226,988
5,11,5011,Arkansas,Bradley County,3707,3699,1364,1580,19,32,954,762,7406,38,2728,1716
5,13,5013,Arkansas,Calhoun County,1994,1926,546,553,5,7,121,93,3920,10,1092,214
5,15,5015,Arkansas,Carroll County,13017,13128,134,104,278,292,2244,2062,26145,556,268,4306
5,17,5017,Arkansas,Chicot County,2231,2118,2732,2793,39,32,336,264,4349,78,5464,600
5,19,5019,Arkansas,Clark County,7783,8376,2516,2976,66,92,526,549,16159,132,5032,1075
5,21,5021,Arkansas,Clay County,6877,7215,76,48,20,16,178,142,14092,40,152,320
5,23,5023,Arkansas,Cleburne County,11819,12229,67,50,34,98,278,333,24048,68,134,611
5,25,5025,Arkansas,Cleveland County,3427,3437,434,484,4,10,115,82,6864,8,868,197
5,27,5027,Arkansas,Columbia County,7140,7273,3837,4524,93,121,369,290,14413,186,7674,659
5,29,5029,Arkansas,Conway County,8669,9007,1170,1211,42,46,432,404,17676,84,2340,836
5,31,5031,Arkansas,Craighead County,42834,44848,8638,9871,762,650,3032,2761,87682,1524,17276,5793
5,33,5033,Arkansas,Crawford County,28391,28993,555,544,452,524,2594,2537,57384,904,1110,5131
5,35,5035,Arkansas,Crittenden County,10182,10432,12058,14089,130,180,696,635,20614,260,24116,1331
5,37,5037,Arkansas,Cross County,5933,6214,1811,1994,69,61,187,141,12147,138,3622,328
5,39,5039,Arkansas,Dallas County,2009,1952,1357,1482,8,11,166,105,3961,16,2714,271
5,41,5041,Arkansas,Desha County,2719,2888,2489,2953,47,33,372,359,5607,94,4978,731
5,43,5043,Arkansas,Drew County,6229,6400,2408,2712,58,67,363,321,12629,116,4816,684
5,45,5045,Arkansas,Faulkner County,51757,53571,7224,8152,735,847,2791,2486,105328,1470,14448,5277
5,47,5047,Arkansas,Franklin County,8301,8418,109,55,101,89,302,272,16719,202,218,574
5,49,5049,Arkansas,Fulton County,5905,6077,46,42,16,26,106,109,11982,32,92,215
5,51,5051,Arkansas,Garland County,41463,44973,4254,4445,340,515,3019,2881,86436,680,8508,5900
5,53,5053,Arkansas,Grant County,8512,8780,263,228,30,43,301,251,17292,60,526,552
5,55,5055,Arkansas,Greene County,21210,21958,427,398,91,94,704,639,43168,182,854,1343
5,57,5057,Arkansas,Hempstead County,7019,7137,2997,3560,43,69,1498,1366,14156,86,5994,2864
5,59,5059,Arkansas,Hot Spring County,14927,13928,2161,1666,55,85,692,553,28855,110,4322,1245
5,61,5061,Arkansas,Howard County,4834,5067,1292,1491,42,33,871,867,9901,84,2584,1738
5,63,5063,Arkansas,Independence County,17302,18176,495,435,155,183,1281,1233,35478,310,990,2514
5,65,5065,Arkansas,Izard County,6642,6310,254,40,20,45,197,149,12952,40,508,346
5,67,5067,Arkansas,Jackson County,6565,6682,1463,1441,37,51,292,211,13247,74,2926,503
5,69,5069,Arkansas,Jefferson County,13554,13057,18506,19848,309,273,860,613,26611,618,37012,1473
5,71,5071,Arkansas,Johnson County,11987,12358,325,258,362,359,1920,1871,24345,724,650,3791
5,73,5073,Arkansas,Lafayette County,2030,2025,1130,1274,22,20,110,85,4055,44,2260,195
5,75,5075,Arkansas,Lawrence County,7727,8103,102,97,22,22,142,150,15830,44,204,292
5,77,5077,Arkansas,Lee County,2267,1546,2591,2226,28,23,135,71,3813,56,5182,206
5,79,5079,Arkansas,Lincoln County,4986,3812,2834,1077,32,15,360,182,8798,64,5668,542
5,81,5081,Arkansas,Little River County,4519,4731,1119,1315,20,37,229,228,9250,40,2238,457
5,83,5083,Arkansas,Logan County,9934,10062,173,145,278,212,356,295,19996,556,346,651
5,85,5085,Arkansas,Lonoke County,32383,33436,2253,2399,239,433,1825,1525,65819,478,4506,3350
5,87,5087,Arkansas,Madison County,7828,7776,84,67,53,72,517,460,15604,106,168,977
5,89,5089,Arkansas,Marion County,7853,8098,52,49,12,91,189,219,15951,24,104,408
5,91,5091,Arkansas,Miller County,15381,15393,5165,5810,110,119,816,736,30774,220,10330,1552
5,93,5093,Arkansas,Mississippi County,12541,12582,6726,7752,96,98,925,866,25123,192,13452,1791
5,95,5095,Arkansas,Monroe County,1790,1970,1231,1461,25,29,107,67,3760,50,2462,174
5,97,5097,Arkansas,Montgomery County,4204,4242,37,35,36,81,195,212,8446,72,74,407
5,99,5099,Arkansas,Nevada County,2737,2746,1227,1319,20,23,201,188,5483,40,2454,389
5,101,5101,Arkansas,Newton County,3737,3647,20,18,5,24,71,80,7384,10,40,151
5,103,5103,Arkansas,Ouachita County,6455,6766,4202,5185,62,57,316,282,13221,124,8404,598
5,105,5105,Arkansas,Perry County,4879,5002,123,89,10,28,195,129,9881,20,246,324
5,107,5107,Arkansas,Phillips County,3157,3144,4977,6097,37,43,195,159,6301,74,9954,354
5,109,5109,Arkansas,Pike County,4899,5017,205,166,44,41,370,336,9916,88,410,706
5,111,5111,Arkansas,Poinsett County,10136,10830,933,1025,38,43,422,360,20966,76,1866,782
5,113,5113,Arkansas,Polk County,9140,9584,73,51,59,132,689,625,18724,118,146,1314
5,115,5115,Arkansas,Pope County,29199,29800,1139,998,336,450,3174,2978,58999,672,2278,6152
5,117,5117,Arkansas,Prairie County,3510,3464,447,473,4,7,101,60,6974,8,894,161
5,119,5119,Arkansas,Pulaski County,109882,114114,67819,80526,4083,4772,13065,11428,223996,8166,135638,24493
5,121,5121,Arkansas,Randolph County,8349,8585,118,94,28,35,216,186,16934,56,236,402
5,123,5123,Arkansas,St. Francis County,6367,4629,6952,6255,79,81,1137,231,10996,158,13904,1368
5,125,5125,Arkansas,Saline County,52792,54874,4849,5472,714,930,3215,3077,107666,1428,9698,6292
5,127,5127,Arkansas,Scott County,4759,4611,39,29,154,164,460,356,9370,308,78,816
5,129,5129,Arkansas,Searcy County,3743,3744,23,17,13,18,140,84,7487,26,46,224
5,131,5131,Arkansas,Sebastian County,51128,53465,4465,4479,2876,3183,9687,9176,104593,5752,8930,18863
5,133,5133,Arkansas,Sevier County,7476,7451,362,352,44,57,3060,2769,14927,88,724,5829
5,135,5135,Arkansas,Sharp County,8100,8480,87,91,72,37,225,225,16580,144,174,450
5,137,5137,Arkansas,Stone County,5978,6059,26,30,26,32,122,116,12037,52,52,238
5,139,5139,Arkansas,Union County,12278,12488,5999,6766,124,139,851,760,24766,248,11998,1611
5,141,5141,Arkansas,Van Buren County,7895,7978,61,41,32,38,298,224,15873,64,122,522
5,143,5143,Arkansas,Washington County,102626,103809,4869,4105,3161,3136,21000,19999,206435,6322,9738,40999
5,145,5145,Arkansas,White County,35086,37119,1835,1805,348,337,1833,1668,72205,696,3670,3501
5,147,5147,Arkansas,Woodruff County,2195,2277,772,881,12,6,86,54,4472,24,1544,140
5,149,5149,Arkansas,Yell County,10012,10018,247,209,138,152,2297,2074,20030,276,494,4371
6,1,6001,California,Alameda County,414416,409177,88167,96201,259991,280400,188611,184444,823593,519982,176334,373055
6,3,6003,California,Alpine County,424,343,0,4,11,7,75,64,767,22,0,139
6,5,6005,California,Amador County,19053,16583,955,111,318,347,3617,2136,35636,636,1910,5753
6,7,6007,California,Butte County,92754,94988,2316,1842,5461,5523,19162,18569,187742,10922,4632,37731
6,9,6009,California,Calaveras County,20794,20958,303,195,390,469,3026,2941,41752,780,606,5967
6,11,6011,California,Colusa County,10011,9619,164,118,152,185,6765,6253,19630,304,328,13018
6,13,6013,California,Contra Costa County,372197,379086,52267,57797,99630,111488,150136,150284,751283,199260,104534,300420
6,15,6015,California,Del Norte County,11674,10046,884,96,410,451,3605,1991,21720,820,1768,5596
6,17,6017,California,El Dorado County,85557,85379,1142,858,4128,5189,12790,12588,170936,8256,2284,25378
6,19,6019,California,Fresno County,382292,382910,29301,28675,54900,56453,271242,265938,765202,109800,58602,537180
6,21,6021,California,Glenn County,12881,12411,226,151,442,448,6336,5743,25292,884,452,12079
6,23,6023,California,Humboldt County,56089,56741,1161,857,1852,2078,8207,8147,112830,3704,2322,16354
6,25,6025,California,Imperial County,82621,80823,4317,1692,1967,1856,77122,76966,163444,3934,8634,154088
6,27,6027,California,Inyo County,7263,7141,136,83,143,164,2169,2061,14404,286,272,4230
6,29,6029,California,Kern County,379621,361338,30296,25986,23750,24529,254029,237516,740959,47500,60592,491545
6,31,6031,California,Kings County,67356,56291,7772,3645,3301,3413,45823,38691,123647,6602,15544,84514
6,33,6033,California,Lake County,27976,28072,746,605,412,476,7297,6874,56048,824,1492,14171
6,35,6035,California,Lassen County,14780,9960,2393,176,268,221,4269,1641,24740,536,4786,5910
6,37,6037,California,Los Angeles County,3552806,3545503,426817,472349,722516,822929,2434231,2447739,7098309,1445032,853634,4881970
6,39,6039,California,Madera County,65900,69283,2268,4287,1955,2063,46122,46361,135183,3910,4536,92483
6,41,6041,California,Marin County,107935,112886,4630,2725,7237,9851,21778,20382,220821,14474,9260,42160
6,43,6043,California,Mariposa County,7801,7563,120,107,140,143,1058,1015,15364,280,240,2073
6,45,6045,California,Mendocino County,37022,37634,629,357,767,1213,11679,10700,74656,1534,1258,22379
6,47,6047,California,Merced County,115016,113129,5682,5255,10903,10665,86220,83222,228145,21806,11364,169442
6,49,6049,California,Modoc County,3909,3889,95,32,55,52,661,630,7798,110,190,1291
6,51,6051,California,Mono County,6890,6129,82,36,215,155,2041,1834,13019,430,164,3875
6,53,6053,California,Monterey County,183308,176247,9038,5932,13386,15824,132888,124833,359555,26772,18076,257721
6,55,6055,California,Napa County,57493,57706,1860,1528,5757,6501,24432,23228,115199,11514,3720,47660
6,57,6057,California,Nevada County,45823,47228,369,262,624,835,5053,4679,93051,1248,738,9732
6,59,6059,California,Orange County,1125286,1133419,35120,32921,326088,363553,541101,539990,2258705,652176,70240,1081091
6,61,6061,California,Placer County,163366,170922,4185,3567,15196,17641,28544,28837,334288,30392,8370,57381
6,63,6063,California,Plumas County,8460,8565,123,79,87,118,878,872,17025,174,246,1750
6,65,6065,California,Riverside County,985814,980433,89748,89848,82579,94146,621835,614197,1966247,165158,179496,1236032
6,67,6067,California,Sacramento County,479127,494837,82361,86220,126300,137713,183797,182967,973964,252600,164722,366764
6,69,6069,California,San Benito County,27468,27401,577,456,1138,1318,19180,19034,54869,2276,1154,38214
6,71,6071,California,San Bernardino County,837353,831623,99480,104974,82347,91179,595069,591739,1668976,164694,198960,1186808
6,73,6073,California,San Diego County,1274179,1243209,99296,85222,197279,222713,566839,573194,2517388,394558,198592,1140033
6,75,6075,California,San Francisco County,250486,214800,25697,23318,147442,169728,70188,64121,465286,294884,51394,134309
6,77,6077,California,San Joaquin County,252915,250635,31504,31743,64171,68073,162895,157439,503550,128342,63008,320334
6,79,6079,California,San Luis Obispo County,126123,125299,4151,1575,5537,5762,33854,31006,251422,11074,8302,64860
6,81,6081,California,San Mateo County,230449,225601,11003,10216,110626,123957,92419,91559,456050,221252,22006,183978
6,83,6083,California,Santa Barbara County,190451,190727,6123,4774,12774,14098,104402,101133,381178,25548,12246,205535
6,85,6085,California,Santa Clara County,516550,492727,28877,25753,374136,378104,244036,238262,1009277,748272,57754,482298
6,87,6087,California,Santa Cruz County,117723,119956,2190,1834,6754,7674,46533,46389,237679,13508,4380,92922
6,89,6089,California,Shasta County,77262,80506,1272,971,2826,2828,9547,9388,157768,5652,2544,18935
6,91,6091,California,Sierra County,1380,1403,16,5,9,17,196,185,2783,18,32,381
6,93,6093,California,Siskiyou County,18587,18793,401,265,311,382,2917,2827,37380,622,802,5744
6,95,6095,California,Solano County,135220,131570,33187,32936,33080,39238,62511,59592,266790,66160,66374,122103
6,97,6097,California,Sonoma County,209590,219252,5555,4689,10082,12508,69053,65901,428842,20164,11110,134954
6,99,6099,California,Stanislaus County,227339,231159,9902,9459,16257,17567,132242,129826,458498,32514,19804,262068
6,101,6101,California,Sutter County,34970,35525,1444,1219,8107,8347,15878,15029,70495,16214,2888,30907
6,103,6103,California,Tehama County,29204,29533,412,284,451,487,8694,8082,58737,902,824,16776
6,105,6105,California,Trinity County,5454,5233,65,28,89,95,460,447,10687,178,130,907
6,107,6107,California,Tulare County,205616,205414,5171,5005,8911,9632,154968,150856,411030,17822,10342,305824
6,109,6109,California,Tuolumne County,25227,23981,907,190,352,457,3978,2928,49208,704,1814,6906
6,111,6111,California,Ventura County,353207,357880,10840,9433,30561,36128,183561,182274,711087,61122,21680,365835
6,113,6113,California,Yolo County,79635,83506,3283,3281,15476,17728,34835,35557,163141,30952,6566,70392
6,115,6115,California,Yuba County,31245,30419,1909,1595,2837,2942,11681,11244,61664,5674,3818,22925
8,1,8001,Colorado,Adams County,224147,219381,11145,9699,11268,11969,107841,103298,443528,22536,22290,211139
8,3,8003,Colorado,Alamosa County,7042,7167,177,121,140,130,3846,3879,14209,280,354,7725
8,5,8005,Colorado,Arapahoe County,249901,252174,38123,37304,20048,22998,65428,64253,502075,40096,76246,129681
8,7,8007,Colorado,Archuleta County,6529,6396,64,37,62,100,1282,1303,12925,124,128,2585
8,9,8009,Colorado,Baca County,1667,1684,26,15,4,10,217,188,3351,8,52,405
8,11,8011,Colorado,Bent County,2951,1819,388,17,66,17,1173,625,4770,132,776,1798
8,13,8013,Colorado,Boulder County,148010,145678,2321,1624,7747,8614,23003,22576,293688,15494,4642,45579
8,14,8014,Colorado,Broomfield County,30795,31076,579,477,2317,2521,4469,4495,61871,4634,1158,8964
8,15,8015,Colorado,Chaffee County,9984,9126,340,35,82,98,1272,755,19110,164,680,2027
8,17,8017,Colorado,Cheyenne County,860,862,6,8,27,15,114,87,1722,54,12,201
8,19,8019,Colorado,Clear Creek County,4829,4305,65,33,48,64,427,310,9134,96,130,737
8,21,8021,Colorado,Conejos County,3759,3760,43,38,34,36,2150,2061,7519,68,86,4211
8,23,8023,Colorado,Costilla County,1747,1670,47,35,34,27,1207,1171,3417,68,94,2378
8,25,8025,Colorado,Crowley County,3557,1444,630,19,57,14,1521,465,5001,114,1260,1986
8,27,8027,Colorado,Custer County,2464,2328,59,22,9,17,166,127,4792,18,118,293
8,29,8029,Colorado,Delta County,14761,14785,183,87,135,134,2583,2186,29546,270,366,4769
8,31,8031,Colorado,Denver County,296971,291499,35674,35307,13391,16293,107679,105305,588470,26782,71348,212984
8,33,8033,Colorado,Dolores County,1007,916,6,3,3,3,74,56,1923,6,12,130
8,35,8035,Colorado,Douglas County,157020,157248,3243,2611,9112,9852,15939,16127,314268,18224,6486,32066
8,37,8037,Colorado,Eagle County,27433,24637,579,258,324,409,8528,7853,52070,648,1158,16381
8,39,8039,Colorado,Elbert County,12723,12481,249,117,105,211,997,1035,25204,210,498,2032
8,41,8041,Colorado,El Paso County,303455,296972,26614,22834,9737,12933,64589,63157,600427,19474,53228,127746
8,43,8043,Colorado,Fremont County,24349,19250,1783,110,315,140,4458,1983,43599,630,3566,6441
8,45,8045,Colorado,Garfield County,28798,27651,455,296,226,341,9155,8423,56449,452,910,17578
8,47,8047,Colorado,Gilpin County,3072,2767,52,29,40,55,234,207,5839,80,104,441
8,49,8049,Colorado,Grand County,8005,6967,95,68,68,71,845,671,14972,136,190,1516
8,51,8051,Colorado,Gunnison County,8841,7551,75,30,67,82,905,772,16392,134,150,1677
8,53,8053,Colorado,Hinsdale County,390,374,6,6,5,3,23,24,764,10,12,47
8,55,8055,Colorado,Huerfano County,3107,3014,48,49,34,27,1213,1126,6121,68,96,2339
8,57,8057,Colorado,Jackson County,669,649,0,1,4,6,100,75,1318,8,0,175
8,59,8059,Colorado,Jefferson County,266311,267149,4955,3570,8255,9805,44823,46039,533460,16510,9910,90862
8,61,8061,Colorado,Kiowa County,655,683,7,2,1,7,68,50,1338,2,14,118
8,63,8063,Colorado,Kit Carson County,3370,3370,34,28,18,32,723,637,6740,36,68,1360
8,65,8065,Colorado,Lake County,4108,3470,43,35,29,33,1520,1360,7578,58,86,2880
8,67,8067,Colorado,La Plata County,25077,24488,249,138,176,238,3602,3577,49565,352,498,7179
8,69,8069,Colorado,Larimer County,164575,165761,2417,1903,3969,4530,21652,20873,330336,7938,4834,42525
8,71,8071,Colorado,Las Animas County,6740,6320,241,80,101,90,3034,2827,13060,202,482,5861
8,73,8073,Colorado,Lincoln County,2895,2241,294,21,25,30,612,230,5136,50,588,842
8,75,8075,Colorado,Logan County,11395,9010,880,136,110,112,2561,1297,20405,220,1760,3858
8,77,8077,Colorado,Mesa County,71683,73178,856,606,625,973,11710,11136,144861,1250,1712,22846
8,79,8079,Colorado,Mineral County,375,371,2,0,0,4,27,21,746,0,4,48
8,81,8081,Colorado,Moffat County,6409,6136,65,44,49,58,1152,999,12545,98,130,2151
8,83,8083,Colorado,Montezuma County,10698,10797,70,61,66,107,1691,1618,21495,132,140,3309
8,85,8085,Colorado,Montrose County,19773,20568,186,136,164,193,4607,4315,40341,328,372,8922
8,87,8087,Colorado,Morgan County,13395,13097,737,490,118,122,5603,4998,26492,236,1474,10601
8,89,8089,Colorado,Otero County,8015,8483,201,111,88,78,3810,3909,16498,176,402,7719
8,91,8091,Colorado,Ouray County,2411,2343,4,0,17,24,175,148,4754,34,8,323
8,93,8093,Colorado,Park County,9373,8423,95,73,77,101,654,548,17796,154,190,1202
8,95,8095,Colorado,Phillips County,2000,2099,34,14,9,14,441,414,4099,18,68,855
8,97,8097,Colorado,Pitkin County,8740,8062,149,52,101,257,900,971,16802,202,298,1871
8,99,8099,Colorado,Prowers County,5772,5686,73,48,35,34,2508,2245,11458,70,146,4753
8,101,8101,Colorado,Pueblo County,74446,77122,2437,1937,844,1013,36162,36566,151568,1688,4874,72728
8,103,8103,Colorado,Rio Blanco County,3041,2885,42,36,15,29,385,293,5926,30,84,678
8,105,8105,Colorado,Rio Grande County,5157,5203,70,50,35,41,2507,2493,10360,70,140,5000
8,107,8107,Colorado,Routt County,12740,11800,169,102,85,156,929,844,24540,170,338,1773
8,109,8109,Colorado,Saguache County,3073,3150,47,36,29,34,1194,1291,6223,58,94,2485
8,111,8111,Colorado,San Juan County,378,311,1,1,3,3,49,42,689,6,2,91
8,113,8113,Colorado,San Miguel County,4115,3654,46,30,28,40,477,459,7769,56,92,936
8,115,8115,Colorado,Sedgwick County,1031,1073,17,4,13,19,182,184,2104,26,34,366
8,117,8117,Colorado,Summit County,16035,13318,276,160,252,203,2444,2086,29353,504,552,4530
8,119,8119,Colorado,Teller County,12115,11703,135,111,94,176,908,893,23818,188,270,1801
8,121,8121,Colorado,Washington County,2452,2247,40,18,11,8,302,233,4699,22,80,535
8,123,8123,Colorado,Weld County,151088,148823,3065,2082,2833,3072,50070,47277,299911,5666,6130,97347
8,125,8125,Colorado,Yuma County,4831,4842,42,20,24,30,1338,1180,9673,48,84,2518
9,1,9001,Connecticut,Fairfield County,363173,376006,56464,65533,26308,29181,97438,96334,739179,52616,112928,193772
9,3,9003,Connecticut,Hartford County,323943,342916,67533,73584,27068,26984,81461,85814,666859,54136,135066,167275
9,5,9005,Connecticut,Litchfield County,82960,85221,2401,1946,1904,1995,6587,6213,168181,3808,4802,12800
9,7,9007,Connecticut,Middlesex County,70306,73771,4437,4622,2393,2915,5256,5396,144077,4786,8874,10652
9,9,9009,Connecticut,New Haven County,320310,340385,60956,68851,17576,19435,80460,83156,660695,35152,121912,163616
9,11,9011,Connecticut,New London County,110674,110929,9884,8661,5532,5939,15042,14401,221603,11064,19768,29443
9,13,9013,Connecticut,Tolland County,66474,67084,3212,2740,3918,3691,4647,4214,133558,7836,6424,8861
9,15,9015,Connecticut,Windham County,53119,54270,2048,1713,843,897,7455,7081,107389,1686,4096,14536
10,1,10001,Delaware,Kent County,57790,60884,23234,26145,1945,2368,6638,6773,118674,3890,46468,13411
10,3,10003,Delaware,New Castle County,176436,184576,69202,78434,16185,16146,29466,28734,361012,32370,138404,58200
10,5,10005,Delaware,Sussex County,93844,100545,13908,14621,1511,1708,11341,10439,194389,3022,27816,21780
11,1,11001,District of Columbia,District of Columbia,162160,162421,147351,177133,13330,18172,40250,39227,324581,26660,294702,79477
12,1,12001,Florida,Alachua County,91487,96471,25573,29932,8054,8497,13624,14598,187958,16108,51146,28222
12,3,12003,Florida,Baker County,12261,11899,2666,1490,87,108,456,375,24160,174,5332,831
12,5,12005,Florida,Bay County,71512,72165,9815,9846,1685,2385,5993,5645,143677,3370,19630,11638
12,7,12007,Florida,Bradford County,11386,10066,3852,1949,78,99,899,432,21452,156,7704,1331
12,9,12009,Florida,Brevard County,246186,254403,31254,33815,6847,8819,32328,33284,500589,13694,62508,65612
12,11,12011,Florida,Broward County,611505,620078,276743,313334,35610,40007,294988,311994,1231583,71220,553486,606982
12,13,12013,Florida,Calhoun County,6073,5594,1199,560,57,69,521,284,11667,114,2398,805
12,15,12015,Florida,Charlotte County,83163,87976,5820,5279,1061,1612,7317,7274,171139,2122,11640,14591
12,17,12017,Florida,Citrus County,67417,71642,2431,2322,1047,1454,4595,4571,139059,2094,4862,9166
12,19,12019,Florida,Clay County,87369,88702,13570,14101,2994,3840,11461,11394,176071,5988,27140,22855
12,21,12021,Florida,Collier County,169530,174343,14184,13972,2620,3385,56451,53486,343873,5240,28368,109937
12,23,12023,Florida,Columbia County,28279,27414,7551,5839,284,441,2582,2255,55693,568,15102,4837
12,27,12027,Florida,DeSoto County,17767,14216,2950,1876,112,95,7845,4367,31983,224,5900,12212
12,29,12029,Florida,Dixie County,7840,6856,1187,455,33,40,449,259,14696,66,2374,708
12,31,12031,Florida,Duval County,287176,293249,137461,157476,22451,25411,50767,49969,580425,44902,274922,100736
12,33,12033,Florida,Escambia County,110265,108930,35047,39020,4707,5909,10211,8683,219195,9414,70094,18894
12,35,12035,Florida,Flagler County,46605,49911,5996,6497,1196,1709,6051,6457,96516,2392,11992,12508
12,37,12037,Florida,Franklin County,5489,4613,1197,411,25,27,506,180,10102,50,2394,686
12,39,12039,Florida,Gadsden County,9508,9640,11622,13718,109,186,2611,2383,19148,218,23244,4994
12,41,12041,Florida,Gilchrist County,8531,8425,769,284,50,56,632,480,16956,100,1538,1112
12,43,12043,Florida,Glades County,5847,5040,1301,587,56,39,1691,1323,10887,112,2602,3014
12,45,12045,Florida,Gulf County,5831,5772,845,698,27,48,267,147,11603,54,1690,414
12,47,12047,Florida,Hamilton County,5048,4006,3010,1779,44,72,872,544,9054,88,6020,1416
12,49,12049,Florida,Hardee County,12532,11264,1128,908,145,152,6429,5328,23796,290,2256,11757
12,51,12051,Florida,Hendry County,18812,16175,2384,2585,209,198,13025,10234,34987,418,4768,23259
12,53,12053,Florida,Hernando County,83689,90133,5782,6001,1218,1561,14357,14419,173822,2436,11564,28776
12,55,12055,Florida,Highlands County,44448,46280,5325,5840,735,910,11908,10501,90728,1470,10650,22409
12,57,12057,Florida,Hillsborough County,539014,551571,124668,139627,31261,34217,217362,219534,1090585,62522,249336,436896
12,59,12059,Florida,Holmes County,8943,8500,1062,262,56,78,343,234,17443,112,2124,577
12,61,12061,Florida,Indian River County,66479,72237,7453,7907,1284,1307,10243,10140,138716,2568,14906,20383
12,63,12063,Florida,Jackson County,16963,15349,7016,5190,160,157,1504,750,32312,320,14032,2254
12,65,12065,Florida,Jefferson County,4782,4288,2536,2242,30,76,353,242,9070,60,5072,595
12,67,12067,Florida,Lafayette County,3760,3356,837,232,9,15,667,500,7116,18,1674,1167
12,69,12069,Florida,Lake County,148561,157538,20329,21795,3728,4567,30769,30619,306099,7456,40658,61388
12,71,12071,Florida,Lee County,328025,341107,34112,35867,5901,7612,87640,85857,669132,11802,68224,173497
12,73,12073,Florida,Leon County,87538,93161,42168,51826,5230,5441,9500,10113,180699,10460,84336,19613
12,75,12075,Florida,Levy County,17701,18414,1849,2014,163,194,1890,1750,36115,326,3698,3640
12,77,12077,Florida,Liberty County,3689,2725,1327,321,15,25,426,162,6414,30,2654,588
12,79,12079,Florida,Madison County,5891,5097,3675,3323,39,52,725,320,10988,78,7350,1045
12,81,12081,Florida,Manatee County,167983,178700,17707,19618,4167,5025,34578,33516,346683,8334,35414,68094
12,83,12083,Florida,Marion County,144065,156003,23392,26006,2794,3598,25909,25727,300068,5588,46784,51636
12,85,12085,Florida,Martin County,71287,73714,4938,4213,1036,1383,12257,10587,145001,2072,9876,22844
12,86,12086,Florida,Miami-Dade County,1046219,1101492,231895,249865,20809,23302,910347,976017,2147711,41618,463790,1886364
12,87,12087,Florida,Monroe County,34127,31934,2876,2378,478,604,9681,9119,66061,956,5752,18800
12,89,12089,Florida,Nassau County,39431,40815,2637,2743,398,493,2059,2105,80246,796,5274,4164
12,91,12091,Florida,Okaloosa County,86888,83958,11770,10300,2523,4117,10366,10166,170846,5046,23540,20532
12,93,12093,Florida,Okeechobee County,19155,17505,2570,1209,195,216,6248,4719,36660,390,5140,10967
12,95,12095,Florida,Orange County,470313,477547,152256,164950,36765,42370,223862,231433,947860,73530,304512,455295
12,97,12097,Florida,Osceola County,146885,150356,26376,26465,5023,5870,103958,105839,297241,10046,52752,209797
12,99,12099,Florida,Palm Beach County,543499,573822,141632,155159,20669,23405,174759,174825,1117321,41338,283264,349584
12,101,12101,Florida,Pasco County,235745,248994,18447,18770,6884,8599,45394,46222,484739,13768,36894,91616
12,103,12103,Florida,Pinellas County,387292,417201,51342,56817,15894,18897,48981,50427,804493,31788,102684,99408
12,105,12105,Florida,Polk County,280480,290372,57089,60509,6365,7475,90687,87715,570852,12730,114178,178402
12,107,12107,Florida,Putnam County,29879,29933,5814,6432,243,276,3922,3675,59812,486,11628,7597
12,109,12109,Florida,St. Johns County,114239,120315,7237,7472,4081,4527,9808,9951,234554,8162,14474,19759
12,111,12111,Florida,St. Lucie County,118589,122927,33986,36426,2678,3849,32784,32526,241516,5356,67972,65310
12,113,12113,Florida,Santa Rosa County,80717,79475,7620,4371,1474,2490,5678,5180,160192,2948,15240,10858
12,115,12115,Florida,Sarasota County,188964,207829,9964,10579,3528,4447,20412,21056,396793,7056,19928,41468
12,117,12117,Florida,Seminole County,179779,190891,29001,32602,11321,12037,51223,54723,370670,22642,58002,105946
12,119,12119,Florida,Sumter County,57757,61776,6573,3124,491,779,4685,3170,119533,982,13146,7855
12,121,12121,Florida,Suwannee County,18966,18450,3191,2410,132,148,2397,2012,37416,264,6382,4409
12,123,12123,Florida,Taylor County,8704,7695,2574,1719,96,101,657,259,16399,192,5148,916
12,125,12125,Florida,Union County,6764,4582,2838,605,51,38,605,246,11346,102,5676,851
12,127,12127,Florida,Volusia County,226387,236904,30682,33050,5146,5832,41396,41553,463291,10292,61364,82949
12,129,12129,Florida,Wakulla County,14399,13399,3176,1515,102,127,765,559,27798,204,6352,1324
12,131,12131,Florida,Walton County,33235,33125,2282,1616,434,600,2639,2155,66360,868,4564,4794
12,133,12133,Florida,Washington County,10688,9734,2489,1364,67,91,573,403,20422,134,4978,976
13,1,13001,Georgia,Appling County,6999,7196,1827,1768,90,63,1004,841,14195,180,3654,1845
13,3,13003,Georgia,Atkinson County,3171,3082,693,725,52,30,1146,928,6253,104,1386,2074
13,5,13005,Georgia,Bacon County,4400,4609,890,920,36,49,513,445,9009,72,1780,958
13,7,13007,Georgia,Baker County,816,791,631,707,20,15,111,82,1607,40,1262,193
13,9,13009,Georgia,Baldwin County,12330,11925,9627,9434,375,407,555,496,24255,750,19254,1051
13,11,13011,Georgia,Banks County,9139,8897,296,253,97,105,756,638,18036,194,592,1394
13,13,13013,Georgia,Barrow County,32723,33831,5128,5597,1672,1660,5181,4956,66554,3344,10256,10137
13,15,13015,Georgia,Bartow County,45238,46193,5939,6285,503,612,5176,4691,91431,1006,11878,9867
13,17,13017,Georgia,Ben Hill County,4851,5170,2803,3378,78,64,532,516,10021,156,5606,1048
13,19,13019,Georgia,Berrien County,8251,8390,1026,1138,108,132,586,477,16641,216,2052,1063
13,21,13021,Georgia,Bibb County,29674,31553,38873,46593,1587,1801,2804,2543,61227,3174,77746,5347
13,23,13023,Georgia,Bleckley County,4401,4657,1557,1906,83,62,240,174,9058,166,3114,414
13,25,13025,Georgia,Brantley County,8853,8995,405,353,32,29,260,173,17848,64,810,433
13,27,13027,Georgia,Brooks County,4751,4742,2521,2925,76,88,483,474,9493,152,5042,957
13,29,13029,Georgia,Bryan County,15410,15619,2891,3125,403,493,1520,1494,31029,806,5782,3014
13,31,13031,Georgia,Bulloch County,26591,26402,11031,12526,490,579,1807,1569,52993,980,22062,3376
13,33,13033,Georgia,Burke County,5561,5706,4799,5703,57,68,426,353,11267,114,9598,779
13,35,13035,Georgia,Butts County,8641,8435,4202,2997,81,99,509,377,17076,162,8404,886
13,37,13037,Georgia,Calhoun County,1364,871,2266,1500,27,26,233,81,2235,54,4532,314
13,39,13039,Georgia,Camden County,21476,19543,5108,5384,375,459,2160,1743,41019,750,10216,3903
13,43,13043,Georgia,Candler County,3876,3908,1258,1433,57,66,717,614,7784,114,2516,1331
13,45,13045,Georgia,Carroll County,45129,46583,11019,12591,553,653,4626,4003,91712,1106,22038,8629
13,47,13047,Georgia,Catoosa County,30454,32495,1003,970,423,528,1083,1065,62949,846,2006,2148
13,49,13049,Georgia,Charlton County,4780,3850,2769,1269,65,45,586,136,8630,130,5538,722
13,51,13051,Georgia,Chatham County,75276,78247,55780,63374,4072,4460,9997,9340,153523,8144,111560,19337
13,53,13053,Georgia,Chattahoochee County,5051,2618,1242,878,210,110,1219,624,7669,420,2484,1843
13,55,13055,Georgia,Chattooga County,10635,10879,1545,881,69,72,781,579,21514,138,3090,1360
13,57,13057,Georgia,Cherokee County,111681,114522,9664,10250,2375,3002,14927,13680,226203,4750,19328,28607
13,59,13059,Georgia,Clarke County,40459,42696,16197,20144,2428,2875,7131,6986,83155,4856,32394,14117
13,61,13061,Georgia,Clay County,494,576,803,908,11,6,23,24,1070,22,1606,47
13,63,13063,Georgia,Clayton County,28181,27674,97057,115562,7063,7624,20237,18957,55855,14126,194114,39194
13,65,13065,Georgia,Clinch County,2212,2361,868,957,11,13,198,185,4573,22,1736,383
13,67,13067,Georgia,Cobb County,234943,239305,101203,117771,20499,22062,52057,49065,474248,40998,202406,101122
13,69,13069,Georgia,Coffee County,14941,14580,6629,5840,184,199,2856,2372,29521,368,13258,5228
13,71,13071,Georgia,Colquitt County,16427,16725,5216,5617,186,212,4917,4009,33152,372,10432,8926
13,73,13073,Georgia,Columbia County,56436,57894,14098,15349,2961,3822,5651,5476,114330,5922,28196,11127
13,75,13075,Georgia,Cook County,5857,6131,2198,2619,60,65,519,519,11988,120,4396,1038
13,77,13077,Georgia,Coweta County,56049,57940,12850,14535,1519,1800,5490,5360,113989,3038,25700,10850
13,79,13079,Georgia,Crawford County,4746,4641,1245,1338,139,28,240,203,9387,278,2490,443
13,81,13081,Georgia,Crisp County,5640,6027,4606,5406,160,136,463,383,11667,320,9212,846
13,83,13083,Georgia,Dade County,7562,7801,116,110,71,99,213,160,15363,142,232,373
13,85,13085,Georgia,Dawson County,12359,12683,174,122,95,147,638,731,25042,190,348,1369
13,87,13087,Georgia,Decatur County,7014,7298,5398,5874,85,90,892,836,14312,170,10796,1728
13,89,13089,Georgia,DeKalb County,133799,138749,190319,226110,24120,25013,33405,31352,272548,48240,380638,64757
13,91,13091,Georgia,Dodge County,7085,6694,3391,2901,47,58,467,276,13779,94,6782,743
13,93,13093,Georgia,Dooly County,3540,2843,3613,3106,58,43,553,388,6383,116,7226,941
13,95,13095,Georgia,Dougherty County,10987,12106,28248,34177,410,411,1408,1281,23093,820,56496,2689
13,97,13097,Georgia,Douglas County,32518,33908,33491,39229,1099,1312,7530,7451,66426,2198,66982,14981
13,99,13099,Georgia,Early County,2284,2400,2359,2909,33,42,125,107,4684,66,4718,232
13,101,13101,Georgia,Echols County,1828,1684,121,127,11,16,680,514,3512,22,242,1194
13,103,13103,Georgia,Effingham County,26164,26463,4517,4689,338,379,1601,1530,52627,676,9034,3131
13,105,13105,Georgia,Elbert County,6307,6786,2532,3034,98,90,600,551,13093,196,5064,1151
13,107,13107,Georgia,Emanuel County,7049,7175,3887,3978,92,77,578,463,14224,184,7774,1041
13,109,13109,Georgia,Evans County,3375,3582,1588,1728,51,76,637,618,6957,102,3176,1255
13,111,13111,Georgia,Fannin County,12242,13075,121,113,99,71,379,306,25317,198,242,685
13,113,13113,Georgia,Fayette County,37299,38989,13671,15228,2795,3058,4218,4345,76288,5590,27342,8563
13,115,13115,Georgia,Floyd County,38416,40746,6990,7737,667,905,6198,5218,79162,1334,13980,11416
13,117,13117,Georgia,Forsyth County,93866,95711,5274,5387,18905,19072,12154,11452,189577,37810,10548,23606
13,119,13119,Georgia,Franklin County,9872,10385,1127,1090,154,173,610,514,20257,308,2254,1124
13,121,13121,Georgia,Fulton County,245498,238340,215692,257328,40989,39907,39644,37129,483838,81978,431384,76773
13,123,13123,Georgia,Gilmer County,14893,15063,295,136,97,130,2032,1676,29956,194,590,3708
13,125,13125,Georgia,Glascock County,1320,1328,111,143,3,0,29,26,2648,6,222,55
13,127,13127,Georgia,Glynn County,27942,31050,10405,12289,625,740,2938,2892,58992,1250,20810,5830
13,129,13129,Georgia,Gordon County,26038,27011,1312,1239,473,361,5018,4551,53049,946,2624,9569
13,131,13131,Georgia,Grady County,8003,8367,3405,3925,91,77,1523,1447,16370,182,6810,2970
13,133,13133,Georgia,Greene County,5695,5890,2841,3180,111,107,640,539,11585,222,5682,1179
13,135,13135,Georgia,Gwinnett County,252204,251567,130398,148347,56092,61372,104552,99071,503771,112184,260796,203623
13,137,13137,Georgia,Habersham County,19751,21337,617,1151,523,532,3691,3356,41088,1046,1234,7047
13,139,13139,Georgia,Hall County,88628,89295,8110,8468,2036,2293,31220,28240,177923,4072,16220,59460
13,141,13141,Georgia,Hancock County,1306,935,3298,2710,59,23,183,47,2241,118,6596,230
13,143,13143,Georgia,Haralson County,13395,14170,665,675,100,153,309,280,27565,200,1330,589
13,145,13145,Georgia,Harris County,14100,13965,2925,2942,155,263,652,711,28065,310,5850,1363
13,147,13147,Georgia,Hart County,10063,10337,2551,2452,134,168,539,452,20400,268,5102,991
13,149,13149,Georgia,Heard County,5200,5162,563,601,39,26,198,152,10362,78,1126,350
13,151,13151,Georgia,Henry County,52135,53730,52434,61049,3782,4209,8412,8571,105865,7564,104868,16983
13,153,13153,Georgia,Houston County,47030,47939,24027,27896,2434,2836,5230,5127,94969,4868,48054,10357
13,155,13155,Georgia,Irwin County,3386,3192,1482,1139,33,50,217,146,6578,66,2964,363
13,157,13157,Georgia,Jackson County,31754,32645,2759,2646,754,793,3080,3073,64399,1508,5518,6153
13,159,13159,Georgia,Jasper County,5489,5581,1300,1468,16,29,303,274,11070,32,2600,577
13,161,13161,Georgia,Jeff Davis County,6137,6207,1109,1204,57,59,1053,887,12344,114,2218,1940
13,163,13163,Georgia,Jefferson County,3490,3471,3783,4297,46,57,374,248,6961,92,7566,622
13,165,13165,Georgia,Jenkins County,2497,2244,2019,1677,27,61,335,207,4741,54,4038,542
13,167,13167,Georgia,Johnson County,3383,2770,1972,1334,22,17,153,119,6153,44,3944,272
13,169,13169,Georgia,Jones County,10121,10683,3433,3820,81,93,284,248,20804,162,6866,532
13,171,13171,Georgia,Lamar County,6259,6571,2558,3121,83,61,264,239,12830,166,5116,503
13,173,13173,Georgia,Lanier County,3831,3763,1186,1112,55,69,362,302,7594,110,2372,664
13,175,13175,Georgia,Laurens County,13720,14640,8118,9714,276,274,682,687,28360,552,16236,1369
13,177,13177,Georgia,Lee County,10848,10850,3556,3413,375,400,549,411,21698,750,7112,960
13,179,13179,Georgia,Liberty County,14891,13915,13519,14108,517,746,3960,3815,28806,1034,27038,7775
13,181,13181,Georgia,Lincoln County,2708,2700,1046,1246,15,24,85,81,5408,30,2092,166
13,183,13183,Georgia,Long County,6434,6404,2787,2593,123,135,1149,1008,12838,246,5574,2157
13,185,13185,Georgia,Lowndes County,33331,34238,20600,23296,1119,1431,3555,3459,67569,2238,41200,7014
13,187,13187,Georgia,Lumpkin County,15708,16120,333,252,129,139,829,881,31828,258,666,1710
13,189,13189,Georgia,McDuffie County,5620,6238,4052,4794,46,57,355,359,11858,92,8104,714
13,191,13191,Georgia,McIntosh County,4516,4629,2258,2558,29,46,165,160,9145,58,4516,325
13,193,13193,Georgia,Macon County,2518,2132,4312,3551,99,83,360,221,4650,198,8624,581
13,195,13195,Georgia,Madison County,12724,12969,1428,1433,274,372,922,893,25693,548,2856,1815
13,197,13197,Georgia,Marion County,2707,2675,1224,1363,41,37,390,255,5382,82,2448,645
13,199,13199,Georgia,Meriwether County,6021,6368,3781,4370,67,66,299,228,12389,134,7562,527
13,201,13201,Georgia,Miller County,1945,1997,704,913,22,14,95,68,3942,44,1408,163
13,205,13205,Georgia,Mitchell County,5516,5270,5496,5002,92,89,611,436,10786,184,10992,1047
13,207,13207,Georgia,Monroe County,10218,10353,3159,3105,122,159,348,302,20571,244,6318,650
13,209,13209,Georgia,Montgomery County,3289,3306,1265,1112,25,31,334,309,6595,50,2530,643
13,211,13211,Georgia,Morgan County,7062,7435,1926,2281,61,70,351,270,14497,122,3852,621
13,213,13213,Georgia,Murray County,18867,19485,280,217,81,132,3234,3054,38352,162,560,6288
13,215,13215,Georgia,Muscogee County,44296,44200,44372,49533,2659,2919,7881,7206,88496,5318,88744,15087
13,217,13217,Georgia,Newton County,26289,27662,24265,29057,641,713,3340,3462,53951,1282,48530,6802
13,219,13219,Georgia,Oconee County,17449,18086,1011,1078,783,901,1200,1111,35535,1566,2022,2311
13,221,13221,Georgia,Oglethorpe County,6039,6083,1317,1317,59,100,412,351,12122,118,2634,763
13,223,13223,Georgia,Paulding County,61398,63463,17479,19407,941,1130,5896,6010,124861,1882,34958,11906
13,225,13225,Georgia,Peach County,7144,7139,5652,6587,128,176,1261,1041,14283,256,11304,2302
13,227,13227,Georgia,Pickens County,15287,15987,224,200,116,136,512,516,31274,232,448,1028
13,229,13229,Georgia,Pierce County,8495,8631,814,905,63,62,541,458,17126,126,1628,999
13,231,13231,Georgia,Pike County,8243,8543,793,946,41,49,179,153,16786,82,1586,332
13,233,13233,Georgia,Polk County,17478,18069,2556,2892,153,172,3177,2606,35547,306,5112,5783
13,235,13235,Georgia,Pulaski County,3228,3968,1379,2183,64,65,214,183,7196,128,2758,397
13,237,13237,Georgia,Putnam County,7793,7938,2690,3132,54,79,731,638,15731,108,5380,1369
13,239,13239,Georgia,Quitman County,539,591,533,583,3,3,18,29,1130,6,1066,47
13,241,13241,Georgia,Rabun County,7932,8348,145,127,80,99,740,606,16280,160,290,1346
13,243,13243,Georgia,Randolph County,1191,1308,1890,2278,19,20,101,80,2499,38,3780,181
13,245,13245,Georgia,Richmond County,38563,36664,54689,62258,1568,1977,5388,4872,75227,3136,109378,10260
13,247,13247,Georgia,Rockdale County,16474,17145,24154,28670,818,898,4830,4689,33619,1636,48308,9519
13,249,13249,Georgia,Schley County,1963,2024,474,591,27,18,116,185,3987,54,948,301
13,251,13251,Georgia,Screven County,3896,3997,2870,2850,41,50,194,158,7893,82,5740,352
13,253,13253,Georgia,Seminole County,2558,2630,1236,1445,31,34,142,149,5188,62,2472,291
13,255,13255,Georgia,Spalding County,20106,20935,10834,12460,315,377,1829,1490,41041,630,21668,3319
13,257,13257,Georgia,Stephens County,10666,11375,1304,1543,104,116,553,452,22041,208,2608,1005
13,259,13259,Georgia,Stewart County,2269,756,1932,1277,188,26,2145,64,3025,376,3864,2209
13,261,13261,Georgia,Sumter County,6333,6592,7031,8589,188,219,978,848,12925,376,14062,1826
13,263,13263,Georgia,Talbot County,1342,1294,1534,1881,6,11,88,93,2636,12,3068,181
13,265,13265,Georgia,Taliaferro County,308,324,412,435,7,13,42,20,632,14,824,62
13,267,13267,Georgia,Tattnall County,9032,7966,5000,2459,85,83,1813,1276,16998,170,10000,3089
13,269,13269,Georgia,Taylor County,2356,2439,1369,1650,35,35,127,84,4795,70,2738,211
13,271,13271,Georgia,Telfair County,5564,4045,3475,2378,82,29,2168,243,9609,164,6950,2411
13,273,13273,Georgia,Terrell County,1585,1602,2361,2762,17,17,125,120,3187,34,4722,245
13,275,13275,Georgia,Thomas County,12985,13932,7371,8732,184,281,951,797,26917,368,14742,1748
13,277,13277,Georgia,Tift County,13145,13576,5823,6669,309,319,2674,2280,26721,618,11646,4954
13,279,13279,Georgia,Toombs County,9084,9800,3196,3860,98,124,1732,1441,18884,196,6392,3173
13,281,13281,Georgia,Towns County,5513,6073,70,70,49,62,182,207,11586,98,140,389
13,283,13283,Georgia,Treutlen County,2286,2292,1077,1122,12,12,132,76,4578,24,2154,208
13,285,13285,Georgia,Troup County,19971,21131,11773,13773,862,777,1370,1239,41102,1724,23546,2609
13,287,13287,Georgia,Turner County,2222,2323,1517,1677,41,37,236,150,4545,82,3034,386
13,289,13289,Georgia,Twiggs County,2277,2331,1590,1713,11,16,102,117,4608,22,3180,219
13,291,13291,Georgia,Union County,11485,12251,125,88,27,92,430,444,23736,54,250,874
13,293,13293,Georgia,Upson County,8726,9367,3371,4117,82,89,334,294,18093,164,6742,628
13,295,13295,Georgia,Walker County,31665,33006,1652,1408,264,266,950,790,64671,528,3304,1740
13,297,13297,Georgia,Walton County,35926,37077,8420,9422,728,881,2335,2319,73003,1456,16840,4654
13,299,13299,Georgia,Ware County,11578,12126,5617,5171,182,168,850,724,23704,364,11234,1574
13,301,13301,Georgia,Warren County,1018,1057,1409,1656,22,15,51,37,2075,44,2818,88
13,303,13303,Georgia,Washington County,4691,4295,5532,5434,60,65,353,181,8986,120,11064,534
13,305,13305,Georgia,Wayne County,11533,11291,3238,2794,108,123,1154,794,22824,216,6476,1948
13,307,13307,Georgia,Webster County,715,719,546,553,7,8,74,56,1434,14,1092,130
13,309,13309,Georgia,Wheeler County,2768,1980,2215,752,20,10,269,154,4748,40,4430,423
13,311,13311,Georgia,White County,14223,15060,355,270,79,91,504,530,29283,158,710,1034
13,313,13313,Georgia,Whitfield County,47039,47742,2395,2212,792,923,19733,18281,94781,1584,4790,38014
13,315,13315,Georgia,Wilcox County,3018,2403,2006,973,40,31,296,133,5421,80,4012,429
13,317,13317,Georgia,Wilkes County,2678,2774,1861,2157,45,42,283,242,5452,90,3722,525
13,319,13319,Georgia,Wilkinson County,2606,2701,1577,1828,15,21,156,121,5307,30,3154,277
13,321,13321,Georgia,Worth County,6881,7207,2590,3080,53,93,250,237,14088,106,5180,487
15,1,15001,Hawaii,Hawaii County,34776,33828,1033,671,19808,22978,12970,13029,68604,39616,2066,25999
15,3,15003,Hawaii,Honolulu County,117410,92956,16624,10842,193414,225021,50547,46734,210366,386828,33248,97281
15,5,15005,Hawaii,Kalawao County,13,11,0,0,6,1,1,0,24,12,0,1
15,7,15007,Hawaii,Kauai County,11804,12080,271,216,10621,11781,4064,4149,23884,21242,542,8213
15,9,15009,Hawaii,Maui County,29388,29051,744,557,22874,25686,9633,9737,58439,45748,1488,19370
16,1,16001,Idaho,Ada County,221611,220939,3807,2828,5847,7284,20842,20203,442550,11694,7614,41045
16,3,16003,Idaho,Adams County,2089,1961,7,9,15,22,75,80,4050,30,14,155
16,5,16005,Idaho,Bannock County,39607,39948,498,461,570,856,4016,3822,79555,1140,996,7838
16,7,16007,Idaho,Bear Lake County,2980,2933,13,10,13,19,152,111,5913,26,26,263
16,9,16009,Idaho,Benewah County,4156,3906,25,18,12,21,177,179,8062,24,50,356
16,11,16011,Idaho,Bingham County,20824,20826,169,112,177,313,4332,4035,41650,354,338,8367
16,13,16013,Idaho,Blaine County,10934,10850,102,51,103,180,2654,2753,21784,206,204,5407
16,15,16015,Idaho,Boise County,3864,3535,18,18,30,49,195,209,7399,60,36,404
16,17,16017,Idaho,Bonner County,21855,21810,94,53,95,262,763,790,43665,190,188,1553
16,19,16019,Idaho,Bonneville County,56076,56280,495,384,630,728,8201,7739,112356,1260,990,15940
16,21,16021,Idaho,Boundary County,5819,5722,51,34,53,65,300,322,11541,106,102,622
16,23,16023,Idaho,Butte County,1277,1208,7,4,2,6,69,70,2485,4,14,139
16,25,16025,Idaho,Camas County,532,512,3,3,2,2,45,25,1044,4,6,70
16,27,16027,Idaho,Canyon County,106222,107975,1008,903,1138,1317,29953,28994,214197,2276,2016,58947
16,29,16029,Idaho,Caribou County,3552,3400,6,3,16,14,264,192,6952,32,12,456
16,31,16031,Idaho,Cassia County,11555,11198,112,98,94,98,3478,3053,22753,188,224,6531
16,33,16033,Idaho,Clark County,402,378,8,2,6,3,195,181,780,12,16,376
16,35,16035,Idaho,Clearwater County,4513,3666,37,18,30,35,233,130,8179,60,74,363
16,37,16037,Idaho,Custer County,2114,2022,20,5,8,6,105,94,4136,16,40,199
16,39,16039,Idaho,Elmore County,12605,11561,514,327,415,430,2696,2191,24166,830,1028,4887
16,41,16041,Idaho,Franklin County,6914,6527,29,18,12,18,491,454,13441,24,58,945
16,43,16043,Idaho,Fremont County,6575,6000,71,39,18,29,894,748,12575,36,142,1642
16,45,16045,Idaho,Gem County,8683,8531,28,18,53,129,830,732,17214,106,56,1562
16,47,16047,Idaho,Gooding County,7275,7032,47,42,65,58,2385,2044,14307,130,94,4429
16,49,16049,Idaho,Idaho County,8133,7426,52,33,36,59,324,269,15559,72,104,593
16,51,16051,Idaho,Jefferson County,14595,13965,85,62,109,73,1725,1439,28560,218,170,3164
16,53,16053,Idaho,Jerome County,11859,11253,103,85,67,78,4882,4230,23112,134,206,9112
16,55,16055,Idaho,Kootenai County,77641,78992,397,303,565,962,4123,4063,156633,1130,794,8186
16,57,16057,Idaho,Latah County,18799,18236,262,190,443,530,904,913,37035,886,524,1817
16,59,16059,Idaho,Lemhi County,3887,3795,18,11,10,24,144,140,7682,20,36,284
16,61,16061,Idaho,Lewis County,1708,1649,16,8,19,45,102,80,3357,38,32,182
16,63,16063,Idaho,Lincoln County,2601,2460,20,8,17,19,892,794,5061,34,40,1686
16,65,16065,Idaho,Madison County,19257,18696,170,131,235,344,1634,1464,37953,470,340,3098
16,67,16067,Idaho,Minidoka County,9884,9931,91,86,53,79,3903,3665,19815,106,182,7568
16,69,16069,Idaho,Nez Perce County,17942,18351,131,84,122,190,841,791,36293,244,262,1632
16,71,16071,Idaho,Oneida County,2215,2200,11,6,9,19,103,98,4415,18,22,201
16,73,16073,Idaho,Owyhee County,5547,5284,55,53,52,44,1622,1424,10831,104,110,3046
16,75,16075,Idaho,Payette County,11256,11230,62,55,113,135,2176,2013,22486,226,124,4189
16,77,16077,Idaho,Power County,3572,3507,44,40,17,22,1356,1299,7079,34,88,2655
16,79,16079,Idaho,Shoshone County,6088,6016,62,24,26,68,265,198,12104,52,124,463
16,81,16081,Idaho,Teton County,6180,5546,29,26,26,43,1074,953,11726,52,58,2027
16,83,16083,Idaho,Twin Falls County,40247,41137,392,398,654,883,7704,7141,81384,1308,784,14845
16,85,16085,Idaho,Valley County,5657,5260,36,18,37,34,288,244,10917,74,72,532
16,87,16087,Idaho,Washington County,4759,4850,36,26,50,52,894,820,9609,100,72,1714
17,1,17001,Illinois,Adams County,29806,30892,1351,1206,263,352,610,551,60698,526,2702,1161
17,3,17003,Illinois,Alexander County,1827,1913,880,950,6,11,50,57,3740,12,1760,107
17,5,17005,Illinois,Bond County,7439,7435,783,258,94,40,411,183,14874,188,1566,594
17,7,17007,Illinois,Boone County,24708,24822,787,716,354,431,6341,5846,49530,708,1574,12187
17,9,17009,Illinois,Brown County,2865,2300,1227,15,14,7,405,51,5165,28,2454,456
17,11,17011,Illinois,Bureau County,15405,15909,167,176,120,225,1595,1491,31314,240,334,3086
17,13,17013,Illinois,Calhoun County,2346,2312,12,9,2,12,35,33,4658,4,24,68
17,15,17015,Illinois,Carroll County,6836,6927,102,55,35,52,295,264,13763,70,204,559
17,17,17017,Illinois,Cass County,5514,5622,368,256,50,48,1240,1109,11136,100,736,2349
17,19,17019,Illinois,Champaign County,74822,75734,13759,15270,11957,10929,6807,6310,150556,23914,27518,13117
17,21,17021,Illinois,Christian County,15668,15423,441,79,85,120,337,218,31091,170,882,555
17,23,17023,Illinois,Clark County,7495,7618,40,35,15,44,141,96,15113,30,80,237
17,25,17025,Illinois,Clay County,6360,6463,41,35,43,72,113,100,12823,86,82,213
17,27,17027,Illinois,Clinton County,17860,17435,1173,203,76,148,744,454,35295,152,2346,1198
17,29,17029,Illinois,Coles County,22790,24193,1029,1012,236,296,712,668,46983,472,2058,1380
17,31,17031,Illinois,Cook County,1674529,1695554,558359,668130,194691,212473,669766,649517,3370083,389382,1116718,1319283
17,33,17033,Illinois,Crawford County,8689,8570,900,70,45,79,289,142,17259,90,1800,431
17,35,17035,Illinois,Cumberland County,5230,5269,28,26,26,42,61,58,10499,52,56,119
17,37,17037,Illinois,DeKalb County,45378,45169,3966,4776,1368,1472,6181,6041,90547,2736,7932,12222
17,39,17039,Illinois,De Witt County,7502,7656,97,56,29,46,227,209,15158,58,194,436
17,41,17041,Illinois,Douglas County,9333,9510,78,56,74,71,769,654,18843,148,156,1423
17,43,17043,Illinois,DuPage County,361872,371442,22726,26094,57352,60155,68487,66023,733314,114704,45452,134510
17,45,17045,Illinois,Edgar County,8211,8564,55,47,26,36,102,129,16775,52,110,231
17,47,17047,Illinois,Edwards County,3055,3167,17,17,9,16,48,41,6222,18,34,89
17,49,17049,Illinois,Effingham County,16544,16629,122,90,115,114,406,376,33173,230,244,782
17,51,17051,Illinois,Fayette County,10110,9843,927,47,36,49,267,125,19953,72,1854,392
17,53,17053,Illinois,Ford County,6154,6347,96,43,25,47,250,231,12501,50,192,481
17,55,17055,Illinois,Franklin County,18397,18971,137,98,62,93,335,328,37368,124,274,663
17,57,17057,Illinois,Fulton County,16163,16064,1284,116,54,53,842,233,32227,108,2568,1075
17,59,17059,Illinois,Gallatin County,2291,2381,24,10,5,7,50,27,4672,10,48,77
17,61,17061,Illinois,Greene County,6325,6293,140,32,19,13,90,78,12618,38,280,168
17,63,17063,Illinois,Grundy County,24319,24479,471,453,187,232,2792,2580,48798,374,942,5372
17,65,17065,Illinois,Hamilton County,3874,4041,33,19,9,21,84,69,7915,18,66,153
17,67,17067,Illinois,Hancock County,8546,8710,59,55,34,33,143,135,17256,68,118,278
17,69,17069,Illinois,Hardin County,1879,1820,9,8,9,10,37,56,3699,18,18,93
17,71,17071,Illinois,Henderson County,3153,3307,16,25,6,26,52,71,6460,12,32,123
17,73,17073,Illinois,Henry County,23282,23489,564,405,97,133,1539,1389,46771,194,1128,2928
17,75,17075,Illinois,Iroquois County,12809,13320,216,115,64,88,1024,954,26129,128,432,1978
17,77,17077,Illinois,Jackson County,22195,21899,3929,4699,1011,1000,1313,1328,44094,2022,7858,2641
17,79,17079,Illinois,Jasper County,4739,4710,18,11,9,23,74,103,9449,18,36,177
17,81,17081,Illinois,Jefferson County,16648,16273,2076,1281,219,228,668,427,32921,438,4152,1095
17,83,17083,Illinois,Jersey County,10275,10733,100,75,38,182,145,169,21008,76,200,314
17,85,17085,Illinois,Jo Daviess County,10322,10338,98,65,43,60,357,313,20660,86,196,670
17,87,17087,Illinois,Johnson County,5788,5510,854,29,13,19,270,120,11298,26,1708,390
17,89,17089,Illinois,Kane County,229898,230907,15803,16107,11139,12151,88254,84107,460805,22278,31606,172361
17,91,17091,Illinois,Kankakee County,44107,45278,8045,8434,573,609,6293,5624,89385,1146,16090,11917
17,93,17093,Illinois,Kendall County,55020,55816,5059,5202,2006,2289,13208,12654,110836,4012,10118,25862
17,95,17095,Illinois,Knox County,21355,22097,2731,1412,214,280,1660,1332,43452,428,5462,2992
17,97,17097,Illinois,Lake County,282991,280486,25477,26629,28519,30309,80357,75915,563477,57038,50954,156272
17,99,17099,Illinois,LaSalle County,51147,51351,2272,857,374,651,5869,5273,102498,748,4544,11142
17,101,17101,Illinois,Lawrence County,7051,6676,1537,72,54,27,509,115,13727,108,3074,624
17,103,17103,Illinois,Lee County,15987,15272,1652,259,129,147,1328,920,31259,258,3304,2248
17,105,17105,Illinois,Livingston County,16416,16698,929,592,161,168,953,741,33114,322,1858,1694
17,107,17107,Illinois,Logan County,12522,12858,1588,853,106,115,655,337,25380,212,3176,992
17,109,17109,Illinois,McDonough County,13120,13562,761,869,371,364,443,431,26682,742,1522,874
17,111,17111,Illinois,McHenry County,142576,143609,2990,2528,4189,5015,22030,20707,286185,8378,5980,42737
17,113,17113,Illinois,McLean County,69330,74211,6930,7471,4547,4225,4467,4395,143541,9094,13860,8862
17,115,17115,Illinois,Macon County,38819,41991,8598,9867,595,608,1256,1233,80810,1190,17196,2489
17,117,17117,Illinois,Macoupin County,21541,22065,233,201,64,123,279,289,43606,128,466,568
17,119,17119,Illinois,Madison County,112782,117662,10705,12521,1220,1490,4666,4369,230444,2440,21410,9035
17,121,17121,Illinois,Marion County,16841,17659,818,776,100,138,449,350,34500,200,1636,799
17,123,17123,Illinois,Marshall County,5476,5611,47,36,24,34,171,168,11087,48,94,339
17,125,17125,Illinois,Mason County,6400,6602,58,31,24,37,96,67,13002,48,116,163
17,127,17127,Illinois,Massac County,5964,6482,421,419,38,38,220,217,12446,76,842,437
17,129,17129,Illinois,Menard County,5766,6047,58,53,15,36,104,92,11813,30,116,196
17,131,17131,Illinois,Mercer County,7469,7556,65,47,30,44,197,212,15025,60,130,409
17,133,17133,Illinois,Monroe County,16862,16972,78,75,73,136,288,282,33834,146,156,570
17,135,17135,Illinois,Montgomery County,13709,13189,942,64,61,80,339,187,26898,122,1884,526
17,137,17137,Illinois,Morgan County,14831,15429,1619,715,139,123,543,360,30260,278,3238,903
17,139,17139,Illinois,Moultrie County,6894,7241,60,52,18,24,132,114,14135,36,120,246
17,141,17141,Illinois,Ogle County,24102,24560,364,270,145,186,2725,2601,48662,290,728,5326
17,143,17143,Illinois,Peoria County,64004,67744,15786,17850,3859,3468,4566,4490,131748,7718,31572,9056
17,145,17145,Illinois,Perry County,9491,8893,1687,216,70,44,524,150,18384,140,3374,674
17,147,17147,Illinois,Piatt County,7879,8029,66,43,37,46,122,128,15908,74,132,250
17,149,17149,Illinois,Pike County,7454,7647,198,31,27,25,130,93,15101,54,396,223
17,151,17151,Illinois,Pope County,1932,1914,158,66,7,10,41,31,3846,14,316,72
17,153,17153,Illinois,Pulaski County,1695,1765,775,860,5,18,66,68,3460,10,1550,134
17,155,17155,Illinois,Putnam County,2856,2714,26,18,10,26,187,172,5570,20,52,359
17,157,17157,Illinois,Randolph County,14258,13439,2894,477,74,89,772,282,27697,148,5788,1054
17,159,17159,Illinois,Richland County,7381,7578,86,57,60,78,139,156,14959,120,172,295
17,161,17161,Illinois,Rock Island County,57088,60103,8222,7494,1977,1789,9514,9239,117191,3954,16444,18753
17,163,17163,Illinois,St. Clair County,83108,85172,36368,42976,1641,2415,5744,5471,168280,3282,72736,11215
17,165,17165,Illinois,Saline County,10643,11177,552,348,59,87,206,203,21820,118,1104,409
17,167,17167,Illinois,Sangamon County,76769,82871,11906,13366,2066,2141,2328,2400,159640,4132,23812,4728
17,169,17169,Illinois,Schuyler County,3311,3120,197,49,7,20,95,62,6431,14,394,157
17,171,17171,Illinois,Scott County,2377,2447,21,10,3,9,40,31,4824,6,42,71
17,173,17173,Illinois,Shelby County,10543,10657,57,30,35,38,132,117,21200,70,114,249
17,175,17175,Illinois,Stark County,2572,2587,18,28,15,21,52,57,5159,30,36,109
17,177,17177,Illinois,Stephenson County,18466,19527,2307,2336,136,174,1029,885,37993,272,4614,1914
17,179,17179,Illinois,Tazewell County,61943,64410,1172,644,500,728,1802,1435,126353,1000,2344,3237
17,181,17181,Illinois,Union County,7953,7987,137,85,35,48,485,396,15940,70,274,881
17,183,17183,Illinois,Vermilion County,30712,31525,5555,5015,300,393,2161,1821,62237,600,11110,3982
17,185,17185,Illinois,Wabash County,5525,5515,70,47,86,53,226,137,11040,172,140,363
17,187,17187,Illinois,Warren County,7589,7928,290,200,228,178,902,760,15517,456,580,1662
17,189,17189,Illinois,Washington County,6742,6761,81,56,30,41,95,105,13503,60,162,200
17,191,17191,Illinois,Wayne County,7783,8004,56,43,42,61,121,139,15787,84,112,260
17,193,17193,Illinois,White County,6413,6731,68,27,31,53,120,90,13144,62,136,210
17,195,17195,Illinois,Whiteside County,25977,26611,557,446,126,190,3482,3332,52588,252,1114,6814
17,197,17197,Illinois,Will County,272567,274475,41467,43057,20011,21745,64118,61257,547042,40022,82934,125375
17,199,17199,Illinois,Williamson County,30070,30929,1906,1190,365,530,1008,809,60999,730,3812,1817
17,201,17201,Illinois,Winnebago County,110151,114841,18819,20631,3874,4138,19239,18941,224992,7748,37638,38180
17,203,17203,Illinois,Woodford County,18634,18656,166,118,151,159,395,340,37290,302,332,735
18,1,18001,Indiana,Adams County,17452,17543,108,90,71,66,844,779,34995,142,216,1623
18,3,18003,Indiana,Allen County,148023,153977,21673,23777,8826,8605,14883,14473,302000,17652,43346,29356
18,5,18005,Indiana,Bartholomew County,35951,36859,1139,835,4137,2996,3293,2726,72810,8274,2278,6019
18,7,18007,Indiana,Benton County,4226,4253,61,36,6,15,254,222,8479,12,122,476
18,9,18009,Indiana,Blackford County,5572,5806,64,26,13,54,87,119,11378,26,128,206
18,11,18011,Indiana,Boone County,31226,31583,740,684,1101,1183,1116,1041,62809,2202,1480,2157
18,13,18013,Indiana,Brown County,7220,7386,63,47,22,50,161,117,14606,44,126,278
18,15,18015,Indiana,Carroll County,9904,9806,124,77,13,24,487,382,19710,26,248,869
18,17,18017,Indiana,Cass County,17284,17579,547,342,429,369,3244,2963,34863,858,1094,6207
18,19,18019,Indiana,Clark County,50384,52964,4887,4999,623,791,3607,3097,103348,1246,9774,6704
18,21,18021,Indiana,Clay County,12635,12850,118,77,50,56,206,184,25485,100,236,390
18,23,18023,Indiana,Clinton County,15646,15814,158,93,59,94,2812,2530,31460,118,316,5342
18,25,18025,Indiana,Crawford County,5209,5059,46,25,12,10,92,72,10268,24,92,164
18,27,18027,Indiana,Daviess County,16018,15863,443,325,82,87,952,795,31881,164,886,1747
18,29,18029,Indiana,Dearborn County,23898,24216,195,150,96,130,348,347,48114,192,390,695
18,31,18031,Indiana,Decatur County,12665,12973,102,66,235,158,307,253,25638,470,204,560
18,33,18033,Indiana,DeKalb County,20973,21350,140,102,93,131,645,592,42323,186,280,1237
18,35,18035,Indiana,Delaware County,48644,52600,4111,4162,728,783,1524,1480,101244,1456,8222,3004
18,37,18037,Indiana,Dubois County,20738,20727,197,173,145,158,2076,1648,41465,290,394,3724
18,39,18039,Indiana,Elkhart County,91184,93430,6344,6257,1107,1420,17951,16629,184614,2214,12688,34580
18,41,18041,Indiana,Fayette County,10995,11284,177,163,37,47,186,153,22279,74,354,339
18,43,18043,Indiana,Floyd County,34503,36527,2101,2224,432,574,1386,1379,71030,864,4202,2765
18,45,18045,Indiana,Fountain County,7936,7986,56,36,17,33,217,218,15922,34,112,435
18,47,18047,Indiana,Franklin County,11090,11134,41,33,67,111,164,125,22224,134,82,289
18,49,18049,Indiana,Fulton County,9560,9618,103,69,59,81,586,494,19178,118,206,1080
18,51,18051,Indiana,Gibson County,15895,15865,517,400,72,119,328,277,31760,144,1034,605
18,53,18053,Indiana,Grant County,27682,30480,2452,2400,269,379,1504,1394,58162,538,4904,2898
18,55,18055,Indiana,Greene County,15607,15615,47,47,56,74,261,251,31222,112,94,512
18,57,18057,Indiana,Hamilton County,142782,149823,7602,7731,10689,11276,7035,7412,292605,21378,15204,14447
18,59,18059,Indiana,Hancock County,36129,37252,1287,1200,310,394,1034,998,73381,620,2574,2032
18,61,18061,Indiana,Harrison County,19700,19658,175,115,68,114,396,441,39358,136,350,837
18,63,18063,Indiana,Hendricks County,73151,74275,7319,6007,2592,2738,3799,3525,147426,5184,14638,7324
18,65,18065,Indiana,Henry County,23372,22250,1120,194,99,117,577,385,45622,198,2240,962
18,67,18067,Indiana,Howard County,34958,37261,3253,3295,560,522,1520,1402,72219,1120,6506,2922
18,69,18069,Indiana,Huntington County,17414,17895,151,123,107,130,526,481,35309,214,302,1007
18,71,18071,Indiana,Jackson County,20610,20909,324,269,678,462,1811,1625,41519,1356,648,3436
18,73,18073,Indiana,Jasper County,16152,16402,192,112,71,91,1035,1034,32554,142,384,2069
18,75,18075,Indiana,Jay County,9957,9985,70,39,31,51,370,293,19942,62,140,663
18,77,18077,Indiana,Jefferson County,14778,15902,289,411,124,152,471,498,30680,248,578,969
18,79,18079,Indiana,Jennings County,13414,13472,136,110,50,56,354,374,26886,100,272,728
18,81,18081,Indiana,Johnson County,70867,73335,2246,1849,3142,3143,3080,2858,144202,6284,4492,5938
18,83,18083,Indiana,Knox County,17292,17204,697,396,165,188,438,387,34496,330,1394,825
18,85,18085,Indiana,Kosciusko County,37602,38058,552,361,767,620,3436,3047,75660,1534,1104,6483
18,87,18087,Indiana,LaGrange County,19663,19113,128,87,84,84,876,790,38776,168,256,1666
18,89,18089,Indiana,Lake County,171231,174707,53600,64955,3980,4353,47793,47461,345938,7960,107200,95254
18,91,18091,Indiana,LaPorte County,47165,46077,7568,5182,325,391,4083,3498,93242,650,15136,7581
18,93,18093,Indiana,Lawrence County,21800,22229,139,91,135,166,416,376,44029,270,278,792
18,95,18095,Indiana,Madison County,56590,57871,6282,4801,341,437,3057,2591,114461,682,12564,5648
18,97,18097,Indiana,Marion County,300084,312707,129574,151093,18616,18290,54230,50832,612791,37232,259148,105062
18,99,18099,Indiana,Marshall County,22161,22462,242,146,145,164,2593,2365,44623,290,484,4958
18,101,18101,Indiana,Martin County,5080,4941,25,11,13,35,55,63,10021,26,50,118
18,103,18103,Indiana,Miami County,16915,15482,1538,263,91,99,753,475,32397,182,3076,1228
18,105,18105,Indiana,Monroe County,63166,64411,2743,2776,5531,5290,2714,2560,127577,11062,5486,5274
18,107,18107,Indiana,Montgomery County,18616,18231,279,158,216,130,1010,882,36847,432,558,1892
18,109,18109,Indiana,Morgan County,34031,34446,240,143,175,331,622,567,68477,350,480,1189
18,111,18111,Indiana,Newton County,6818,6667,86,54,17,81,510,448,13485,34,172,958
18,113,18113,Indiana,Noble County,23021,23062,402,155,109,149,2600,2425,46083,218,804,5025
18,115,18115,Indiana,Ohio County,2846,2888,23,15,7,14,44,55,5734,14,46,99
18,117,18117,Indiana,Orange County,9393,9493,186,139,36,48,191,165,18886,72,372,356
18,119,18119,Indiana,Owen County,10147,10062,67,44,36,88,134,144,20209,72,134,278
18,121,18121,Indiana,Parke County,7774,8436,75,378,8,25,162,137,16210,16,150,299
18,123,18123,Indiana,Perry County,9606,8610,527,47,40,60,152,117,18216,80,1054,269
18,125,18125,Indiana,Pike County,6025,6034,61,27,7,77,98,97,12059,14,122,195
18,127,18127,Indiana,Porter County,77384,79158,3708,3858,1275,1370,8844,8875,156542,2550,7416,17719
18,129,18129,Indiana,Posey County,12330,12278,142,125,46,121,170,143,24608,92,284,313
18,131,18131,Indiana,Pulaski County,6088,5839,76,44,47,39,190,199,11927,94,152,389
18,133,18133,Indiana,Putnam County,17922,17037,1221,222,181,274,443,320,34959,362,2442,763
18,135,18135,Indiana,Randolph County,11732,12189,114,69,42,54,503,420,23921,84,228,923
18,137,18137,Indiana,Ripley County,13661,13830,81,56,134,108,300,230,27491,268,162,530
18,139,18139,Indiana,Rush County,7900,8146,101,73,32,33,127,165,16046,64,202,292
18,141,18141,Indiana,St. Joseph County,106081,110527,17779,19817,3499,3866,12830,11982,216608,6998,35558,24812
18,143,18143,Indiana,Scott County,11385,11796,78,51,65,161,335,253,23181,130,156,588
18,145,18145,Indiana,Shelby County,21298,21628,341,295,190,181,981,966,42926,380,682,1947
18,147,18147,Indiana,Spencer County,9931,9768,111,86,26,44,325,288,19699,52,222,613
18,149,18149,Indiana,Starke County,11191,11249,57,43,17,37,472,482,22440,34,114,954
18,151,18151,Indiana,Steuben County,16933,16544,191,118,116,120,684,612,33477,232,382,1296
18,153,18153,Indiana,Sullivan County,10074,9170,976,37,30,23,247,119,19244,60,1952,366
18,155,18155,Indiana,Switzerland County,5333,5071,121,28,10,28,104,100,10404,20,242,204
18,157,18157,Indiana,Tippecanoe County,81743,80095,5625,5926,9922,7244,8857,8206,161838,19844,11250,17063
18,159,18159,Indiana,Tipton County,7303,7406,67,45,40,46,247,196,14709,80,134,443
18,161,18161,Indiana,Union County,3372,3449,33,35,12,17,64,63,6821,24,66,127
18,163,18163,Indiana,Vanderburgh County,75052,79981,8775,9101,1223,1389,2647,2508,155033,2446,17550,5155
18,165,18165,Indiana,Vermillion County,7528,7563,46,38,23,21,92,111,15091,46,92,203
18,167,18167,Indiana,Vigo County,46606,47167,4768,3163,1122,1117,1868,1138,93773,2244,9536,3006
18,169,18169,Indiana,Wabash County,14526,15388,127,137,73,112,431,416,29914,146,254,847
18,171,18171,Indiana,Warren County,4002,4048,14,19,18,31,93,89,8050,36,28,182
18,173,18173,Indiana,Warrick County,28887,30103,623,499,794,888,632,617,58990,1588,1246,1249
18,175,18175,Indiana,Washington County,13679,13755,88,55,38,47,208,172,27434,76,176,380
18,177,18177,Indiana,Wayne County,28682,30916,1749,1567,310,403,1111,1019,59598,620,3498,2130
18,179,18179,Indiana,Wells County,13528,13887,145,104,62,127,529,411,27415,124,290,940
18,181,18181,Indiana,White County,11572,11664,131,86,44,92,1132,994,23236,88,262,2126
18,183,18183,Indiana,Whitley County,16452,16578,100,67,88,92,365,384,33030,176,200,749
19,1,19001,Iowa,Adair County,3458,3508,24,18,23,15,92,90,6966,46,48,182
19,3,19003,Iowa,Adams County,1751,1758,10,8,11,14,27,25,3509,22,20,52
19,5,19005,Iowa,Allamakee County,6698,6456,126,96,16,47,541,432,13154,32,252,973
19,7,19007,Iowa,Appanoose County,5921,6062,67,50,40,45,152,126,11983,80,134,278
19,9,19009,Iowa,Audubon County,2613,2748,18,13,15,21,50,55,5361,30,36,105
19,11,19011,Iowa,Benton County,12462,12524,106,80,62,47,178,227,24986,124,212,405
19,13,19013,Iowa,Black Hawk County,54530,56321,6201,6528,1751,1562,3084,2938,110851,3502,12402,6022
19,15,19015,Iowa,Boone County,12800,12543,196,115,55,74,376,324,25343,110,392,700
19,17,19017,Iowa,Bremer County,11926,12203,172,130,130,159,196,209,24129,260,344,405
19,19,19019,Iowa,Buchanan County,10214,10401,71,51,63,68,207,163,20615,126,142,370
19,21,19021,Iowa,Buena Vista County,8056,8165,407,263,1030,937,2642,2543,16221,2060,814,5185
19,23,19023,Iowa,Butler County,6984,7115,24,25,88,42,113,93,14099,176,48,206
19,25,19025,Iowa,Calhoun County,4720,4530,195,35,21,11,110,92,9250,42,390,202
19,27,19027,Iowa,Carroll County,9620,9891,152,122,54,56,304,272,19511,108,304,576
19,29,19029,Iowa,Cass County,6127,6350,37,22,24,37,208,156,12477,48,74,364
19,31,19031,Iowa,Cedar County,8990,9110,69,50,47,62,225,206,18100,94,138,431
19,33,19033,Iowa,Cerro Gordo County,19509,20584,522,356,243,237,1101,1057,40093,486,1044,2158
19,35,19035,Iowa,Cherokee County,5403,5439,89,46,33,37,261,202,10842,66,178,463
19,37,19037,Iowa,Chickasaw County,5867,5804,57,35,15,32,194,147,11671,30,114,341
19,39,19039,Iowa,Clarke County,4560,4388,68,50,28,51,807,642,8948,56,136,1449
19,41,19041,Iowa,Clay County,7596,7893,86,62,65,62,333,325,15489,130,172,658
19,43,19043,Iowa,Clayton County,8652,8465,103,47,21,26,199,153,17117,42,206,352
19,45,19045,Iowa,Clinton County,21355,22185,714,708,144,181,826,706,43540,288,1428,1532
19,47,19047,Iowa,Crawford County,7711,7659,390,213,233,180,2530,2323,15370,466,780,4853
19,49,19049,Iowa,Dallas County,41333,42968,1345,1131,2406,2307,2973,2874,84301,4812,2690,5847
19,51,19051,Iowa,Davis County,4380,4450,16,6,9,20,77,73,8830,18,32,150
19,53,19053,Iowa,Decatur County,3733,3735,114,54,31,34,157,100,7468,62,228,257
19,55,19055,Iowa,Delaware County,8412,8210,87,61,28,30,134,146,16622,56,174,280
19,57,19057,Iowa,Des Moines County,16971,17921,1214,1205,161,227,670,652,34892,322,2428,1322
19,59,19059,Iowa,Dickinson County,8335,8436,67,38,51,88,201,179,16771,102,134,380
19,61,19061,Iowa,Dubuque County,44282,45770,1856,1681,611,616,1247,1313,90052,1222,3712,2560
19,63,19063,Iowa,Emmet County,4341,4322,68,56,31,30,516,416,8663,62,136,932
19,65,19065,Iowa,Fayette County,9345,9411,225,78,124,107,294,238,18756,248,450,532
19,67,19067,Iowa,Floyd County,7266,7427,224,217,115,132,295,303,14693,230,448,598
19,69,19069,Iowa,Franklin County,4907,4752,67,55,22,40,781,570,9659,44,134,1351
19,71,19071,Iowa,Fremont County,3373,3385,42,23,18,7,103,107,6758,36,84,210
19,73,19073,Iowa,Greene County,4265,4355,29,18,26,29,155,128,8620,52,58,283
19,75,19075,Iowa,Grundy County,5923,6055,44,30,19,26,97,74,11978,38,88,171
19,77,19077,Iowa,Guthrie County,5186,5214,42,29,15,22,155,145,10400,30,84,300
19,79,19079,Iowa,Hamilton County,6870,7034,124,77,182,166,451,469,13904,364,248,920
19,81,19081,Iowa,Hancock County,5198,5118,44,63,21,33,295,229,10316,42,88,524
19,83,19083,Iowa,Hardin County,7974,8134,218,42,85,95,423,334,16108,170,436,757
19,85,19085,Iowa,Harrison County,6881,6815,34,25,19,37,134,131,13696,38,68,265
19,87,19087,Iowa,Henry County,9367,9067,406,144,241,272,561,465,18434,482,812,1026
19,89,19089,Iowa,Howard County,4465,4467,32,28,9,25,77,82,8932,18,64,159
19,91,19091,Iowa,Humboldt County,4543,4720,47,35,25,23,208,223,9263,50,94,431
19,93,19093,Iowa,Ida County,3329,3350,20,16,17,29,118,99,6679,34,40,217
19,95,19095,Iowa,Iowa County,7848,7858,74,52,38,52,290,233,15706,76,148,523
19,97,19097,Iowa,Jackson County,9399,9370,69,67,36,55,165,148,18769,72,138,313
19,99,19099,Iowa,Jasper County,17933,17512,653,210,105,136,534,490,35445,210,1306,1024
19,101,19101,Iowa,Jefferson County,7725,7570,332,140,1744,356,320,269,15295,3488,664,589
19,103,19103,Iowa,Johnson County,62100,63362,5875,5493,4735,5123,4342,4369,125462,9470,11750,8711
19,105,19105,Iowa,Jones County,10145,9613,401,152,59,62,263,197,19758,118,802,460
19,107,19107,Iowa,Keokuk County,5043,4960,47,26,11,27,109,83,10003,22,94,192
19,109,19109,Iowa,Kossuth County,7234,7089,87,74,33,55,247,248,14323,66,174,495
19,111,19111,Iowa,Lee County,15728,15842,698,360,105,106,667,573,31570,210,1396,1240
19,113,19113,Iowa,Linn County,98076,101699,7368,6525,2807,3030,3810,3865,199775,5614,14736,7675
19,115,19115,Iowa,Louisa County,5200,5112,78,39,237,149,956,821,10312,474,156,1777
19,117,19117,Iowa,Lucas County,4289,4102,35,15,13,18,112,93,8391,26,70,205
19,119,19119,Iowa,Lyon County,5808,5634,29,19,14,29,199,127,11442,28,58,326
19,121,19121,Iowa,Madison County,7954,7860,71,33,38,109,176,187,15814,76,142,363
19,123,19123,Iowa,Mahaska County,10571,10363,267,140,181,191,294,244,20934,362,534,538
19,125,19125,Iowa,Marion County,15925,16035,185,101,235,246,329,341,31960,470,370,670
19,127,19127,Iowa,Marshall County,17987,17878,557,341,778,705,4762,4303,35865,1556,1114,9065
19,129,19129,Iowa,Mills County,7341,7295,74,38,25,38,258,267,14636,50,148,525
19,131,19131,Iowa,Mitchell County,5169,5192,30,31,11,37,97,86,10361,22,60,183
19,133,19133,Iowa,Monona County,4008,4273,42,21,9,15,96,97,8281,18,84,193
19,135,19135,Iowa,Monroe County,3733,3759,32,31,12,19,109,98,7492,24,64,207
19,137,19137,Iowa,Montgomery County,4653,4964,33,29,16,22,236,170,9617,32,66,406
19,139,19139,Iowa,Muscatine County,19756,20027,759,539,242,255,3977,3832,39783,484,1518,7809
19,141,19141,Iowa,O'Brien County,6625,6612,127,81,40,68,400,335,13237,80,254,735
19,143,19143,Iowa,Osceola County,2884,2830,42,19,28,26,278,231,5714,56,84,509
19,145,19145,Iowa,Page County,7370,6796,364,70,65,68,356,203,14166,130,728,559
19,147,19147,Iowa,Palo Alto County,4205,4244,98,91,42,41,153,123,8449,84,196,276
19,149,19149,Iowa,Plymouth County,11970,11971,232,160,69,108,725,752,23941,138,464,1477
19,151,19151,Iowa,Pocahontas County,3141,3202,41,30,9,30,139,130,6343,18,82,269
19,153,19153,Iowa,Polk County,204446,211827,17824,17285,12329,12141,22021,20456,416273,24658,35648,42477
19,155,19155,Iowa,Pottawattamie County,43312,44726,945,728,364,508,3880,3511,88038,728,1890,7391
19,157,19157,Iowa,Poweshiek County,8489,8961,160,148,134,214,290,297,17450,268,320,587
19,159,19159,Iowa,Ringgold County,2358,2405,20,14,11,12,73,59,4763,22,40,132
19,161,19161,Iowa,Sac County,4676,4778,22,21,25,26,211,160,9454,50,44,371
19,163,19163,Iowa,Scott County,72775,75141,6693,7136,2458,2540,6157,5870,147916,4916,13386,12027
19,165,19165,Iowa,Shelby County,5483,5593,74,58,33,32,200,176,11076,66,148,376
19,167,19167,Iowa,Sioux County,16919,16825,179,101,153,160,2055,1855,33744,306,358,3910
19,169,19169,Iowa,Story County,43416,40702,1688,1321,4553,3344,1872,1708,84118,9106,3376,3580
19,171,19171,Iowa,Tama County,7356,7278,108,55,32,48,997,819,14634,64,216,1816
19,173,19173,Iowa,Taylor County,3038,2923,19,15,9,19,269,206,5961,18,38,475
19,175,19175,Iowa,Union County,5742,6057,87,81,41,47,224,162,11799,82,174,386
19,177,19177,Iowa,Van Buren County,3536,3326,8,8,18,23,67,63,6862,36,16,130
19,179,19179,Iowa,Wapello County,15725,16055,785,558,295,266,2084,1814,31780,590,1570,3898
19,181,19181,Iowa,Warren County,24439,25180,265,217,153,219,835,772,49619,306,530,1607
19,183,19183,Iowa,Washington County,10430,10728,142,125,62,86,740,693,21158,124,284,1433
19,185,19185,Iowa,Wayne County,3110,3155,23,9,10,27,56,50,6265,20,46,106
19,187,19187,Iowa,Webster County,16709,16086,1138,550,208,231,1068,900,32795,416,2276,1968
19,189,19189,Iowa,Winnebago County,4859,5010,98,75,44,57,283,245,9869,88,196,528
19,191,19191,Iowa,Winneshiek County,9633,9740,96,74,113,127,278,196,19373,226,192,474
19,193,19193,Iowa,Woodbury County,43897,44782,2710,2091,1455,1578,9241,8677,88679,2910,5420,17918
19,195,19195,Iowa,Worth County,3611,3519,45,28,15,29,129,120,7130,30,90,249
19,197,19197,Iowa,Wright County,6040,6020,78,69,42,39,875,788,12060,84,156,1663
20,1,20001,Kansas,Allen County,5643,5803,144,126,59,86,248,221,11446,118,288,469
20,3,20003,Kansas,Anderson County,3762,3785,29,20,22,33,79,84,7547,44,58,163
20,5,20005,Kansas,Atchison County,7059,7545,402,375,51,54,277,235,14604,102,804,512
20,7,20007,Kansas,Barber County,2156,2059,29,15,7,15,99,107,4215,14,58,206
20,9,20009,Kansas,Barton County,12085,12389,251,239,29,46,2072,1868,24474,58,502,3940
20,11,20011,Kansas,Bourbon County,6513,6837,310,161,67,96,231,179,13350,134,620,410
20,13,20013,Kansas,Brown County,3991,4139,86,63,28,30,264,241,8130,56,172,505
20,15,20015,Kansas,Butler County,30857,31087,1104,382,438,508,1848,1595,61944,876,2208,3443
20,17,20017,Kansas,Chase County,1285,1253,32,1,2,6,76,51,2538,4,64,127
20,19,20019,Kansas,Chautauqua County,1465,1408,29,17,2,4,63,68,2873,4,58,131
20,21,20021,Kansas,Cherokee County,8780,9072,104,70,42,49,265,269,17852,84,208,534
20,23,20023,Kansas,Cheyenne County,1303,1274,10,1,11,25,93,96,2577,22,20,189
20,25,20025,Kansas,Clark County,923,952,7,2,18,12,116,104,1875,36,14,220
20,27,20027,Kansas,Clay County,3795,3860,54,29,17,26,110,110,7655,34,108,220
20,29,20029,Kansas,Cloud County,4121,4230,54,40,77,25,149,148,8351,154,108,297
20,31,20031,Kansas,Coffey County,3856,3938,39,37,36,46,109,119,7794,72,78,228
20,33,20033,Kansas,Comanche County,799,830,5,3,3,5,70,65,1629,6,10,135
20,35,20035,Kansas,Cowley County,15482,15548,590,402,321,356,2085,1835,31030,642,1180,3920
20,37,20037,Kansas,Crawford County,17654,17810,526,414,342,399,1209,1165,35464,684,1052,2374
20,39,20039,Kansas,Decatur County,1373,1355,17,16,1,6,44,48,2728,2,34,92
20,41,20041,Kansas,Dickinson County,8703,8747,133,73,53,85,472,423,17450,106,266,895
20,43,20043,Kansas,Doniphan County,3507,3527,175,75,11,27,99,110,7034,22,350,209
20,45,20045,Kansas,Douglas County,50328,51576,3129,2572,3141,2987,3990,3957,101904,6282,6258,7947
20,47,20047,Kansas,Edwards County,1337,1267,28,22,2,4,314,277,2604,4,56,591
20,49,20049,Kansas,Elk County,1184,1184,2,2,5,8,68,51,2368,10,4,119
20,51,20051,Kansas,Ellis County,13559,13415,232,164,242,275,921,774,26974,484,464,1695
20,53,20053,Kansas,Ellsworth County,3029,2548,318,11,21,16,245,140,5577,42,636,385
20,55,20055,Kansas,Finney County,16292,15937,1107,503,808,719,9653,8860,32229,1616,2214,18513
20,57,20057,Kansas,Ford County,16000,15004,617,337,229,261,9948,8890,31004,458,1234,18838
20,59,20059,Kansas,Franklin County,11980,12137,223,162,66,75,566,517,24117,132,446,1083
20,61,20061,Kansas,Geary County,11573,10434,3105,2631,441,617,2699,2449,22007,882,6210,5148
20,63,20063,Kansas,Gove County,1276,1284,13,3,13,10,43,39,2560,26,26,82
20,65,20065,Kansas,Graham County,1101,1150,51,46,20,21,44,53,2251,40,102,97
20,67,20067,Kansas,Grant County,3338,3356,43,31,20,23,1812,1655,6694,40,86,3467
20,69,20069,Kansas,Gray County,2903,2836,59,54,12,21,508,454,5739,24,118,962
20,71,20071,Kansas,Greeley County,586,613,4,4,2,3,120,121,1199,4,8,241
20,73,20073,Kansas,Greenwood County,2823,2835,22,16,8,16,133,115,5658,16,44,248
20,75,20075,Kansas,Hamilton County,1215,1126,48,31,3,3,523,416,2341,6,96,939
20,77,20077,Kansas,Harper County,2575,2582,18,19,12,16,195,141,5157,24,36,336
20,79,20079,Kansas,Harvey County,15822,16385,350,277,157,212,2275,1903,32207,314,700,4178
20,81,20081,Kansas,Haskell County,1901,1877,19,6,11,20,668,576,3778,22,38,1244
20,83,20083,Kansas,Hodgeman County,835,820,12,12,54,23,68,55,1655,108,24,123
20,85,20085,Kansas,Jackson County,5688,5644,78,34,25,40,362,276,11332,50,156,638
20,87,20087,Kansas,Jefferson County,9259,8987,88,60,21,33,303,263,18246,42,176,566
20,89,20089,Kansas,Jewell County,1438,1365,7,3,8,6,33,41,2803,16,14,74
20,91,20091,Kansas,Johnson County,255435,266462,15023,14772,16004,16232,23952,23771,521897,32008,30046,47723
20,93,20093,Kansas,Kearny County,1788,1809,25,19,9,16,649,603,3597,18,50,1252
20,95,20095,Kansas,Kingman County,3426,3448,14,15,16,30,138,134,6874,32,28,272
20,97,20097,Kansas,Kiowa County,1151,1188,21,13,16,21,76,76,2339,32,42,152
20,99,20099,Kansas,Labette County,8611,8781,481,357,52,45,457,457,17392,104,962,914
20,101,20101,Kansas,Lane County,722,721,11,7,1,4,69,68,1443,2,22,137
20,103,20103,Kansas,Leavenworth County,36099,33193,4934,2668,570,686,3519,2421,69292,1140,9868,5940
20,105,20105,Kansas,Lincoln County,1420,1443,16,5,4,8,55,55,2863,8,32,110
20,107,20107,Kansas,Linn County,4700,4580,58,29,13,21,162,118,9280,26,116,280
20,109,20109,Kansas,Logan County,1335,1345,13,10,16,9,96,97,2680,32,26,193
20,111,20111,Kansas,Lyon County,14478,15458,438,407,426,461,3731,3500,29936,852,876,7231
20,113,20113,Kansas,McPherson County,13290,13856,235,142,99,163,665,607,27146,198,470,1272
20,115,20115,Kansas,Marion County,5603,5739,85,42,22,32,234,256,11342,44,170,490
20,117,20117,Kansas,Marshall County,4653,4714,37,21,14,30,142,119,9367,28,74,261
20,119,20119,Kansas,Meade County,1950,1892,26,18,14,22,417,346,3842,28,52,763
20,121,20121,Kansas,Miami County,16178,16376,327,197,76,122,607,566,32554,152,654,1173
20,123,20123,Kansas,Mitchell County,2911,2870,13,6,22,31,84,75,5781,44,26,159
20,125,20125,Kansas,Montgomery County,13273,13636,917,760,184,137,1239,1048,26909,368,1834,2287
20,127,20127,Kansas,Morris County,2705,2690,18,15,9,32,163,133,5395,18,36,296
20,129,20129,Kansas,Morton County,1193,1178,24,19,22,22,317,267,2371,44,48,584
20,131,20131,Kansas,Nemaha County,4989,4893,45,34,17,18,103,133,9882,34,90,236
20,133,20133,Kansas,Neosho County,7467,7571,124,81,53,60,524,413,15038,106,248,937
20,135,20135,Kansas,Ness County,1293,1346,15,13,1,5,134,153,2639,2,30,287
20,137,20137,Kansas,Norton County,2728,2282,177,15,26,12,195,100,5010,52,354,295
20,139,20139,Kansas,Osage County,7683,7632,76,35,19,54,284,267,15315,38,152,551
20,141,20141,Kansas,Osborne County,1668,1612,11,6,8,33,50,30,3280,16,22,80
20,143,20143,Kansas,Ottawa County,2837,2652,40,27,9,13,93,62,5489,18,80,155
20,145,20145,Kansas,Pawnee County,3173,2622,291,76,21,12,291,178,5795,42,582,469
20,147,20147,Kansas,Phillips County,2516,2533,14,9,23,28,81,91,5049,46,28,172
20,149,20149,Kansas,Pottawatomie County,11407,11587,177,118,108,132,603,646,22994,216,354,1249
20,151,20151,Kansas,Pratt County,4274,4321,95,64,37,53,330,339,8595,74,190,669
20,153,20153,Kansas,Rawlins County,1224,1188,14,10,4,18,111,83,2412,8,28,194
20,155,20155,Kansas,Reno County,28432,28981,1467,639,180,183,3110,2928,57413,360,2934,6038
20,157,20157,Kansas,Republic County,2227,2251,20,17,16,13,66,47,4478,32,40,113
20,159,20159,Kansas,Rice County,4409,4451,111,55,40,81,615,491,8860,80,222,1106
20,161,20161,Kansas,Riley County,32715,29272,2991,2183,1827,1826,3309,2963,61987,3654,5982,6272
20,163,20163,Kansas,Rooks County,2314,2415,17,23,11,30,67,53,4729,22,34,120
20,165,20165,Kansas,Rush County,1501,1423,10,6,2,10,66,61,2924,4,20,127
20,167,20167,Kansas,Russell County,3197,3309,60,31,21,27,142,128,6506,42,120,270
20,169,20169,Kansas,Saline County,24098,24766,1134,832,590,663,3286,3126,48864,1180,2268,6412
20,171,20171,Kansas,Scott County,2298,2289,22,17,37,25,478,406,4587,74,44,884
20,173,20173,Kansas,Sedgwick County,206935,210381,23524,24303,11191,12463,39486,38154,417316,22382,47048,77640
20,175,20175,Kansas,Seward County,9711,9285,488,493,341,295,7076,6455,18996,682,976,13531
20,177,20177,Kansas,Shawnee County,72005,76919,7355,7641,1269,1494,11348,11323,148924,2538,14710,22671
20,179,20179,Kansas,Sheridan County,1239,1208,12,9,4,5,73,71,2447,8,24,144
20,181,20181,Kansas,Sherman County,2827,2821,30,37,16,13,362,374,5648,32,60,736
20,183,20183,Kansas,Smith County,1738,1706,7,3,10,7,41,43,3444,20,14,84
20,185,20185,Kansas,Stafford County,1991,1934,17,12,8,12,304,251,3925,16,34,555
20,187,20187,Kansas,Stanton County,930,923,15,5,3,4,403,359,1853,6,30,762
20,189,20189,Kansas,Stevens County,2540,2646,30,17,20,17,1039,1013,5186,40,60,2052
20,191,20191,Kansas,Sumner County,10774,10700,163,140,43,100,644,637,21474,86,326,1281
20,193,20193,Kansas,Thomas County,3607,3801,51,39,22,41,290,292,7408,44,102,582
20,195,20195,Kansas,Trego County,1374,1333,12,9,8,6,39,35,2707,16,24,74
20,197,20197,Kansas,Wabaunsee County,3397,3216,31,19,7,15,180,137,6613,14,62,317
20,199,20199,Kansas,Wallace County,731,725,10,4,0,1,71,67,1456,0,20,138
20,201,20201,Kansas,Washington County,2675,2559,13,17,15,28,124,92,5234,30,26,216
20,203,20203,Kansas,Wichita County,1041,971,24,13,5,3,354,296,2012,10,48,650
20,205,20205,Kansas,Wilson County,3997,4055,27,18,11,33,164,148,8052,22,54,312
20,207,20207,Kansas,Woodson County,1482,1494,12,8,1,3,56,48,2976,2,24,104
20,209,20209,Kansas,Wyandotte County,56036,55029,17498,19915,4832,4151,25823,23543,111065,9664,34996,49366
21,1,21001,Kentucky,Adair County,9003,9207,345,209,41,37,235,180,18210,82,690,415
21,3,21003,Kentucky,Allen County,10186,10428,165,102,24,35,287,228,20614,48,330,515
21,5,21005,Kentucky,Anderson County,10585,11041,260,226,66,95,249,189,21626,132,520,438
21,7,21007,Kentucky,Ballard County,3638,3716,151,121,25,18,60,57,7354,50,302,117
21,9,21009,Kentucky,Barren County,19750,21235,945,919,175,197,823,702,40985,350,1890,1525
21,11,21011,Kentucky,Bath County,5972,6061,88,83,10,41,108,107,12033,20,176,215
21,13,21013,Kentucky,Bell County,12021,12702,389,252,47,48,156,149,24723,94,778,305
21,15,21015,Kentucky,Boone County,60047,61742,2779,2363,1605,1627,2975,2886,121789,3210,5558,5861
21,17,21017,Kentucky,Bourbon County,8792,9244,586,589,49,57,806,544,18036,98,1172,1350
21,19,21019,Kentucky,Boyd County,21593,22607,1004,343,129,148,533,344,44200,258,2008,877
21,21,21021,Kentucky,Boyle County,13004,13471,1417,1042,124,183,542,495,26475,248,2834,1037
21,23,21023,Kentucky,Bracken County,4042,4031,37,26,2,4,82,59,8073,4,74,141
21,25,21025,Kentucky,Breathitt County,6132,6162,53,27,44,30,69,77,12294,88,106,146
21,27,21027,Kentucky,Breckinridge County,9792,9723,233,210,34,42,234,164,19515,68,466,398
21,29,21029,Kentucky,Bullitt County,38891,39457,666,511,217,282,964,908,78348,434,1332,1872
21,31,21031,Kentucky,Butler County,6273,6244,54,38,23,21,224,211,12517,46,108,435
21,33,21033,Kentucky,Caldwell County,5698,6064,343,348,33,28,130,86,11762,66,686,216
21,35,21035,Kentucky,Calloway County,17320,18611,885,684,320,388,524,542,35931,640,1770,1066
21,37,21037,Kentucky,Campbell County,43177,44778,1433,1407,444,558,1085,937,87955,888,2866,2022
21,39,21039,Kentucky,Carlisle County,2235,2297,39,31,8,6,54,63,4532,16,78,117
21,41,21041,Kentucky,Carroll County,5030,4997,127,96,32,32,398,344,10027,64,254,742
21,43,21043,Kentucky,Carter County,12868,13312,116,70,28,44,212,173,26180,56,232,385
21,45,21045,Kentucky,Casey County,7639,8033,82,97,24,33,241,235,15672,48,164,476
21,47,21047,Kentucky,Christian County,27144,23418,7867,7726,565,491,3383,2348,50562,1130,15734,5731
21,49,21049,Kentucky,Clark County,16407,17181,855,898,92,147,651,461,33588,184,1710,1112
21,51,21051,Kentucky,Clay County,9523,9230,678,137,19,16,337,86,18753,38,1356,423
21,53,21053,Kentucky,Clinton County,4856,5061,45,16,12,22,156,138,9917,24,90,294
21,55,21055,Kentucky,Crittenden County,4276,4266,72,24,14,7,53,54,8542,28,144,107
21,57,21057,Kentucky,Cumberland County,3044,3222,103,91,4,8,45,55,6266,8,206,100
21,59,21059,Kentucky,Daviess County,44545,47250,2737,2444,1003,926,1812,1539,91795,2006,5474,3351
21,61,21061,Kentucky,Edmonson County,5853,5811,177,63,12,35,112,67,11664,24,354,179
21,63,21063,Kentucky,Elliott County,3927,3176,281,6,10,6,54,34,7103,20,562,88
21,65,21065,Kentucky,Estill County,6829,7004,35,33,6,8,88,89,13833,12,70,177
21,67,21067,Kentucky,Fayette County,122422,127038,24408,25902,6537,6851,12924,11036,249460,13074,48816,23960
21,69,21069,Kentucky,Fleming County,6910,7214,111,111,20,23,128,86,14124,40,222,214
21,71,21071,Kentucky,Floyd County,16895,17847,247,147,46,63,167,160,34742,92,494,327
21,73,21073,Kentucky,Franklin County,20684,22340,2688,2723,529,533,1000,836,43024,1058,5376,1836
21,75,21075,Kentucky,Fulton County,2153,2115,723,737,26,25,68,69,4268,52,1446,137
21,77,21077,Kentucky,Gallatin County,4290,4175,95,52,19,22,277,183,8465,38,190,460
21,79,21079,Kentucky,Garrard County,8328,8603,201,174,17,33,215,168,16931,34,402,383
21,81,21081,Kentucky,Grant County,12104,12169,167,87,58,67,388,333,24273,116,334,721
21,83,21083,Kentucky,Graves County,16815,17629,793,784,104,96,1430,1250,34444,208,1586,2680
21,85,21085,Kentucky,Grayson County,12804,12825,250,70,33,37,198,173,25629,66,500,371
21,87,21087,Kentucky,Green County,5140,5331,116,107,8,14,111,99,10471,16,232,210
21,89,21089,Kentucky,Greenup County,16542,17506,183,125,91,106,236,164,34048,182,366,400
21,91,21091,Kentucky,Hancock County,4311,4120,83,52,11,18,77,67,8431,22,166,144
21,93,21093,Kentucky,Hardin County,44528,44783,7167,6878,1019,1479,3412,3078,89311,2038,14334,6490
21,95,21095,Kentucky,Harlan County,11911,13040,288,257,52,51,150,132,24951,104,576,282
21,97,21097,Kentucky,Harrison County,8770,9243,271,168,25,38,296,172,18013,50,542,468
21,99,21099,Kentucky,Hart County,8657,9027,482,383,37,54,186,169,17684,74,964,355
21,101,21101,Kentucky,Henderson County,19240,20720,1845,1960,122,131,675,600,39960,244,3690,1275
21,103,21103,Kentucky,Henry County,7499,7679,255,222,28,35,308,237,15178,56,510,545
21,105,21105,Kentucky,Hickman County,1821,2018,186,225,9,10,51,38,3839,18,372,89
21,107,21107,Kentucky,Hopkins County,19602,20608,1507,1551,111,169,544,433,40210,222,3014,977
21,109,21109,Kentucky,Jackson County,6552,6594,25,18,1,17,62,59,13146,2,50,121
21,111,21111,Kentucky,Jefferson County,268692,281966,79887,91585,11542,11780,23544,21811,550658,23084,159774,45355
21,113,21113,Kentucky,Jessamine County,24149,25444,1205,1292,294,394,1140,858,49593,588,2410,1998
21,115,21115,Kentucky,Johnson County,10646,11034,57,37,58,56,108,85,21680,116,114,193
21,117,21117,Kentucky,Kenton County,75144,77154,4341,3897,1038,1137,2989,2748,152298,2076,8682,5737
21,119,21119,Kentucky,Knott County,7121,7342,87,63,12,11,79,77,14463,24,174,156
21,121,21121,Kentucky,Knox County,14631,15470,236,172,60,50,232,180,30101,120,472,412
21,123,21123,Kentucky,Larue County,6665,6912,250,195,23,27,274,189,13577,46,500,463
21,125,21125,Kentucky,Laurel County,28881,30107,301,194,173,176,537,445,58988,346,602,982
21,127,21127,Kentucky,Lawrence County,7376,7537,37,29,26,17,106,107,14913,52,74,213
21,129,21129,Kentucky,Lee County,3890,3172,188,18,6,12,54,46,7062,12,376,100
21,131,21131,Kentucky,Leslie County,4841,4835,21,20,12,16,44,33,9676,24,42,77
21,133,21133,Kentucky,Letcher County,10332,10835,68,63,18,29,98,83,21167,36,136,181
21,135,21135,Kentucky,Lewis County,6516,6548,32,26,4,4,52,53,13064,8,64,105
21,137,21137,Kentucky,Lincoln County,11529,11972,273,270,30,50,239,186,23501,60,546,425
21,139,21139,Kentucky,Livingston County,4364,4517,27,32,14,21,107,122,8881,28,54,229
21,141,21141,Kentucky,Logan County,12149,12423,858,856,45,47,466,342,24572,90,1716,808
21,143,21143,Kentucky,Lyon County,4094,3442,413,65,13,32,111,72,7536,26,826,183
21,145,21145,Kentucky,McCracken County,26817,28927,3383,3837,274,351,890,890,55744,548,6766,1780
21,147,21147,Kentucky,McCreary County,8125,7600,967,47,51,19,378,88,15725,102,1934,466
21,149,21149,Kentucky,McLean County,4392,4552,54,30,10,16,83,80,8944,20,108,163
21,151,21151,Kentucky,Madison County,41343,43972,2139,2095,470,551,1328,1140,85315,940,4278,2468
21,153,21153,Kentucky,Magoffin County,5999,5971,19,11,9,10,81,65,11970,18,38,146
21,155,21155,Kentucky,Marion County,8614,8747,684,662,70,88,279,243,17361,140,1368,522
21,157,21157,Kentucky,Marshall County,14924,15454,92,66,45,89,287,294,30378,90,184,581
21,159,21159,Kentucky,Martin County,5324,4909,764,22,16,9,350,45,10233,32,1528,395
21,161,21161,Kentucky,Mason County,7446,7907,550,523,81,75,214,149,15353,162,1100,363
21,163,21163,Kentucky,Meade County,13292,13039,635,500,96,136,559,559,26331,192,1270,1118
21,165,21165,Kentucky,Menifee County,3081,3112,146,38,5,8,39,38,6193,10,292,77
21,167,21167,Kentucky,Mercer County,9982,10474,427,376,57,86,345,329,20456,114,854,674
21,169,21169,Kentucky,Metcalfe County,4798,4927,98,79,12,15,108,99,9725,24,196,207
21,171,21171,Kentucky,Monroe County,5093,5131,128,115,8,23,191,141,10224,16,256,332
21,173,21173,Kentucky,Montgomery County,13021,13751,406,352,58,72,444,353,26772,116,812,797
21,175,21175,Kentucky,Morgan County,6851,5537,625,18,50,46,100,38,12388,100,1250,138
21,177,21177,Kentucky,Muhlenberg County,14411,14150,935,561,48,54,262,213,28561,96,1870,475
21,179,21179,Kentucky,Nelson County,21089,21578,1134,1227,111,133,562,459,42667,222,2268,1021
21,181,21181,Kentucky,Nicholas County,3500,3602,32,32,9,11,97,80,7102,18,64,177
21,183,21183,Kentucky,Ohio County,11592,11637,235,117,33,45,486,365,23229,66,470,851
21,185,21185,Kentucky,Oldham County,31403,29774,2075,834,529,634,1515,1173,61177,1058,4150,2688
21,187,21187,Kentucky,Owen County,5274,5324,82,44,8,12,149,145,10598,16,164,294
21,189,21189,Kentucky,Owsley County,2130,2190,12,10,0,4,44,32,4320,0,24,76
21,191,21191,Kentucky,Pendleton County,7221,6924,87,64,20,21,126,93,14145,40,174,219
21,193,21193,Kentucky,Perry County,12172,12513,239,185,128,103,151,134,24685,256,478,285
21,195,21195,Kentucky,Pike County,27582,28972,273,170,123,178,277,327,56554,246,546,604
21,197,21197,Kentucky,Powell County,5909,6058,79,58,21,27,144,84,11967,42,158,228
21,199,21199,Kentucky,Pulaski County,30568,32038,455,340,171,348,971,696,62606,342,910,1667
21,201,21201,Kentucky,Robertson County,1023,1017,13,11,1,1,17,17,2040,2,26,34
21,203,21203,Kentucky,Rockcastle County,8008,8316,45,36,10,11,80,90,16324,20,90,170
21,205,21205,Kentucky,Rowan County,11264,12209,236,200,74,126,216,213,23473,148,472,429
21,207,21207,Kentucky,Russell County,8518,8809,90,73,36,55,393,322,17327,72,180,715
21,209,21209,Kentucky,Scott County,25355,26360,1653,1483,383,391,1303,1146,51715,766,3306,2449
21,211,21211,Kentucky,Shelby County,21093,22331,1749,1826,288,239,2623,2185,43424,576,3498,4808
21,213,21213,Kentucky,Simpson County,7918,8245,895,883,67,90,248,227,16163,134,1790,475
21,215,21215,Kentucky,Spencer County,9400,9179,208,147,27,42,314,225,18579,54,416,539
21,217,21217,Kentucky,Taylor County,11421,12172,766,589,108,113,350,303,23593,216,1532,653
21,219,21219,Kentucky,Todd County,5454,5558,533,457,17,21,277,260,11012,34,1066,537
21,221,21221,Kentucky,Trigg County,6560,6620,497,516,21,26,201,153,13180,42,994,354
21,223,21223,Kentucky,Trimble County,4088,4063,33,36,21,32,169,112,8151,42,66,281
21,225,21225,Kentucky,Union County,6021,6037,1263,629,58,38,195,105,12058,116,2526,300
21,227,21227,Kentucky,Warren County,53437,56161,6432,6518,3043,3007,3878,3591,109598,6086,12864,7469
21,229,21229,Kentucky,Washington County,5465,5612,339,330,43,54,274,209,11077,86,678,483
21,231,21231,Kentucky,Wayne County,9628,9817,245,152,41,54,415,330,19445,82,490,745
21,233,21233,Kentucky,Webster County,5901,6132,313,214,38,29,388,340,12033,76,626,728
21,235,21235,Kentucky,Whitley County,17237,17922,201,137,87,65,252,272,35159,174,402,524
21,237,21237,Kentucky,Wolfe County,3425,3588,17,10,7,2,36,35,7013,14,34,71
21,239,21239,Kentucky,Woodford County,11811,12819,648,690,79,119,1054,781,24630,158,1296,1835
22,1,22001,Louisiana,Acadia Parish,24230,25205,5396,5747,82,128,991,741,49435,164,10792,1732
22,3,22003,Louisiana,Allen Parish,10000,8548,3861,1948,93,69,317,271,18548,186,7722,588
22,5,22005,Louisiana,Ascension Parish,45772,46160,14436,15898,859,926,4017,3525,91932,1718,28872,7542
22,7,22007,Louisiana,Assumption Parish,7305,7584,3059,3418,48,44,411,317,14889,96,6118,728
22,9,22009,Louisiana,Avoyelles Parish,13076,13565,6388,5578,108,100,404,425,26641,216,12776,829
22,11,22011,Louisiana,Beauregard Parish,15762,15527,2506,2022,91,154,725,713,31289,182,5012,1438
22,13,22013,Louisiana,Bienville Parish,3581,3837,2601,2908,19,25,139,140,7418,38,5202,279
22,15,22015,Louisiana,Bossier Parish,45762,45403,13857,15513,1039,1330,4731,4029,91165,2078,27714,8760
22,17,22017,Louisiana,Caddo Parish,54372,57362,55129,64858,1441,1668,3529,3359,111734,2882,110258,6888
22,19,22019,Louisiana,Calcasieu Parish,70093,72474,25236,27303,1424,1361,4386,3965,142567,2848,50472,8351
22,21,22021,Louisiana,Caldwell Parish,4079,4037,919,676,16,17,150,165,8116,32,1838,315
22,23,22023,Louisiana,Cameron Parish,3205,3293,142,134,11,16,158,138,6498,22,284,296
22,25,22025,Louisiana,Catahoula Parish,3252,3164,1671,1242,2,4,92,73,6416,4,3342,165
22,27,22027,Louisiana,Claiborne Parish,3858,3315,4851,3270,38,31,116,127,7173,76,9702,243
22,29,22029,Louisiana,Concordia Parish,5679,5551,3901,3764,54,30,191,139,11230,108,7802,330
22,31,22031,Louisiana,De Soto Parish,8267,8556,4562,5224,39,63,391,431,16823,78,9124,822
22,33,22033,Louisiana,East Baton Rouge Parish,102910,106544,95295,112193,7690,7253,10372,9008,209454,15380,190590,19380
22,35,22035,Louisiana,East Carroll Parish,1059,938,2590,2128,16,19,99,88,1997,32,5180,187
22,37,22037,Louisiana,East Feliciana Parish,5592,4951,4642,3529,22,36,188,155,10543,44,9284,343
22,39,22039,Louisiana,Evangeline Parish,11798,11407,4826,4592,104,67,1002,347,23205,208,9652,1349
22,41,22041,Louisiana,Franklin Parish,6465,6736,3078,3349,33,42,180,156,13201,66,6156,336
22,43,22043,Louisiana,Grant Parish,9636,8497,2463,985,71,48,916,228,18133,142,4926,1144
22,45,22045,Louisiana,Iberia Parish,21399,21830,10844,12049,953,917,1712,1293,43229,1906,21688,3005
22,47,22047,Louisiana,Iberville Parish,8079,8068,7989,7755,86,71,511,392,16147,172,15978,903
22,49,22049,Louisiana,Jackson Parish,5549,5345,2344,2113,23,36,162,116,10894,46,4688,278
22,51,22051,Louisiana,Jefferson Parish,137523,143300,56909,65581,9211,9255,33470,31057,280823,18422,113818,64527
22,53,22053,Louisiana,Jefferson Davis Parish,12262,12815,2556,2609,51,98,462,392,25077,102,5112,854
22,55,22055,Louisiana,Lafayette Parish,82859,86042,31002,34644,2384,2388,5977,5287,168901,4768,62004,11264
22,57,22057,Louisiana,Lafourche Parish,38698,39851,6199,6995,460,409,2369,1899,78549,920,12398,4268
22,59,22059,Louisiana,LaSalle Parish,6405,6263,1130,666,25,24,314,113,12668,50,2260,427
22,61,22061,Louisiana,Lincoln Parish,13104,13020,8776,10251,449,283,782,671,26124,898,17552,1453
22,63,22063,Louisiana,Livingston Parish,62712,64471,4830,5167,443,568,2965,2755,127183,886,9660,5720
22,65,22065,Louisiana,Madison Parish,1949,1944,3386,3468,23,11,123,121,3893,46,6772,244
22,67,22067,Louisiana,Morehouse Parish,6047,6403,5624,6292,50,67,215,167,12450,100,11248,382
22,69,22069,Louisiana,Natchitoches Parish,10179,10624,7432,8336,145,103,480,479,20803,290,14864,959
22,71,22071,Louisiana,Orleans Parish,68410,67873,106591,127855,5502,5917,11179,10305,136283,11004,213182,21484
22,73,22073,Louisiana,Ouachita Parish,44314,47058,26931,30833,810,799,1791,1647,91372,1620,53862,3438
22,75,22075,Louisiana,Plaquemines Parish,8157,7944,2470,2474,505,488,984,842,16101,1010,4940,1826
22,77,22077,Louisiana,Pointe Coupee Parish,6667,6946,3566,4149,35,39,315,303,13613,70,7132,618
22,79,22079,Louisiana,Rapides Parish,40290,42281,19632,21828,917,903,2263,1931,82571,1834,39264,4194
22,81,22081,Louisiana,Red River Parish,2388,2545,1573,1777,10,9,129,103,4933,20,3146,232
22,83,22083,Louisiana,Richland Parish,6168,6418,3471,3696,25,40,231,250,12586,50,6942,481
22,85,22085,Louisiana,Sabine Parish,8279,8324,1929,2079,39,60,452,485,16603,78,3858,937
22,87,22087,Louisiana,St. Bernard Parish,16614,16511,5170,6182,503,564,2576,2300,33125,1006,10340,4876
22,89,22089,Louisiana,St. Charles Parish,18378,18917,6786,7267,251,330,1701,1683,37295,502,13572,3384
22,91,22091,Louisiana,St. Helena Parish,2292,2343,2446,2824,10,8,103,103,4635,20,4892,206
22,93,22093,Louisiana,St. James Parish,5207,5288,4816,5470,40,45,227,160,10495,80,9632,387
22,95,22095,Louisiana,St. John the Baptist Parish,8247,8199,11902,13102,323,175,1480,1377,16446,646,23804,2857
22,97,22097,Louisiana,St. Landry Parish,22490,23682,16151,17961,189,196,966,974,46172,378,32302,1940
22,99,22099,Louisiana,St. Martin Parish,17755,17963,7662,8363,242,266,867,736,35718,484,15324,1603
22,101,22101,Louisiana,St. Mary Parish,15100,15383,7592,8135,479,352,1981,1567,30483,958,15184,3548
22,103,22103,Louisiana,St. Tammany Parish,106034,110712,15611,17515,1707,2112,8000,7316,216746,3414,31222,15316
22,105,22105,Louisiana,Tangipahoa Parish,44377,45704,19069,21859,456,490,3300,2641,90081,912,38138,5941
22,107,22107,Louisiana,Tensas Parish,963,934,1136,1224,4,6,58,45,1897,8,2272,103
22,109,22109,Louisiana,Terrebonne Parish,38728,39390,10110,11125,647,568,3217,2449,78118,1294,20220,5666
22,111,22111,Louisiana,Union Parish,8106,8050,2625,2909,30,30,566,513,16156,60,5250,1079
22,113,22113,Louisiana,Vermilion Parish,23466,25010,3980,4538,628,614,1078,1086,48476,1256,7960,2164
22,115,22115,Louisiana,Vernon Parish,19429,17387,3706,3244,389,524,2461,2018,36816,778,7412,4479
22,117,22117,Louisiana,Washington Parish,15403,15707,6919,7127,74,64,607,544,31110,148,13838,1151
22,119,22119,Louisiana,Webster Parish,11931,12297,6285,6881,68,92,407,406,24228,136,12570,813
22,121,22121,Louisiana,West Baton Rouge Parish,7659,7595,5037,5525,110,86,500,401,15254,220,10074,901
22,123,22123,Louisiana,West Carroll Parish,4381,4414,961,804,14,18,257,209,8795,28,1922,466
22,125,22125,Louisiana,West Feliciana Parish,4680,3694,5316,1586,16,75,146,111,8374,32,10632,257
22,127,22127,Louisiana,Winn Parish,4735,4478,2521,1802,13,22,182,114,9213,26,5042,296
23,1,23001,Maine,Androscoggin County,48510,50803,2499,2373,479,535,1070,1030,99313,958,4998,2100
23,3,23003,Maine,Aroostook County,31467,32100,455,341,125,218,485,421,63567,250,910,906
23,5,23005,Maine,Cumberland County,131427,139966,4949,4502,3047,4010,3209,3157,271393,6094,9898,6366
23,7,23007,Maine,Franklin County,14363,14856,109,58,62,98,197,209,29219,124,218,406
23,9,23009,Maine,Hancock County,25595,27074,245,322,275,409,433,429,52669,550,490,862
23,11,23011,Maine,Kennebec County,56910,60209,619,372,533,674,1024,1032,117119,1066,1238,2056
23,13,23013,Maine,Knox County,18938,19392,245,88,105,154,290,334,38330,210,490,624
23,15,23015,Maine,Lincoln County,16391,17128,141,80,123,148,234,233,33519,246,282,467
23,17,23017,Maine,Oxford County,27517,28298,213,189,266,204,460,414,55815,532,426,874
23,19,23019,Maine,Penobscot County,71308,72746,881,612,846,991,1135,1101,144054,1692,1762,2236
23,21,23021,Maine,Piscataquis County,8031,8063,61,43,96,81,128,124,16094,192,122,252
23,23,23023,Maine,Sagadahoc County,16700,17709,201,130,150,162,360,306,34409,300,402,666
23,25,23025,Maine,Somerset County,24181,24477,202,121,167,206,316,279,48658,334,404,595
23,27,23027,Maine,Waldo County,18898,19470,155,87,100,149,375,280,38368,200,310,655
23,29,23029,Maine,Washington County,14015,14641,128,94,74,84,391,414,28656,148,256,805
23,31,23031,Maine,York County,96500,101643,1250,926,1273,1576,1939,1891,198143,2546,2500,3830
24,1,24001,Maryland,Allegany County,30968,31174,4539,1279,349,448,870,486,62142,698,9078,1356
24,3,24003,Maryland,Anne Arundel County,212577,213735,51507,54417,11174,13263,25229,23569,426312,22348,103014,48798
24,5,24005,Maryland,Baltimore County,240404,257576,113188,137721,25563,26703,25015,23059,497980,51126,226376,48074
24,9,24009,Maryland,Calvert County,37302,37662,5996,6290,751,999,2035,2033,74964,1502,11992,4068
24,11,24011,Maryland,Caroline County,13248,13810,2209,2508,198,202,1400,1208,27058,396,4418,2608
24,13,24013,Maryland,Carroll County,76133,78277,3679,2918,1571,1939,3346,3162,154410,3142,7358,6508
24,15,24015,Maryland,Cecil County,44893,45934,3811,3690,669,801,2535,2285,90827,1338,7622,4820
24,17,24017,Maryland,Charles County,33736,34196,38627,43137,2444,3101,5093,5118,67932,4888,77254,10211
24,19,24019,Maryland,Dorchester County,10242,11061,4264,5002,174,219,931,1018,21303,348,8528,1949
24,21,24021,Maryland,Frederick County,103011,106380,13957,13718,6127,6737,13819,13547,209391,12254,27914,27366
24,23,24023,Maryland,Garrett County,13907,14325,214,108,36,84,180,166,28232,72,428,346
24,25,24025,Maryland,Harford County,99060,102270,18221,19677,3663,4205,6340,5875,201330,7326,36442,12215
24,27,24027,Maryland,Howard County,90833,91390,30741,35672,30718,32102,12082,11800,182223,61436,61482,23882
24,29,24029,Maryland,Kent County,7614,8176,1361,1532,131,140,513,358,15790,262,2722,871
24,31,24031,Maryland,Montgomery County,310147,319916,98795,112752,76944,86901,106459,104314,630063,153888,197590,210773
24,33,24033,Maryland,Prince George's County,128346,117799,270884,314429,19224,20937,94682,83045,246145,38448,541768,177727
24,35,24035,Maryland,Queen Anne's County,22444,22808,1640,1554,279,324,1079,1069,45252,558,3280,2148
24,37,24037,Maryland,St. Mary's County,44746,43849,8268,8601,1432,1864,3371,2971,88595,2864,16536,6342
24,39,24039,Maryland,Somerset County,7177,6719,6137,4497,122,136,508,526,13896,244,12274,1034
24,41,24041,Maryland,Talbot County,14678,16295,2216,2542,236,302,1342,1334,30973,472,4432,2676
24,43,24043,Maryland,Washington County,61126,62804,11678,7243,1394,1527,4543,4167,123930,2788,23356,8710
24,45,24045,Maryland,Wicomico County,32573,36066,13312,15024,1474,1662,2937,2805,68639,2948,26624,5742
24,47,24047,Maryland,Worcester County,21128,22283,3183,3630,403,398,1024,922,43411,806,6366,1946
24,510,24510,Maryland,Baltimore city,93405,95241,169203,203074,7798,8435,17397,16255,188646,15596,338406,33652
25,1,25001,Massachusetts,Barnstable County,93306,103033,3887,3478,1608,1780,3802,3433,196339,3216,7774,7235
25,3,25003,Massachusetts,Berkshire County,55456,59291,2304,2220,880,1202,3308,3114,114747,1760,4608,6422
25,5,25005,Massachusetts,Bristol County,240793,258298,17247,17193,6390,7567,24380,24188,499091,12780,34494,48568
25,7,25007,Massachusetts,Dukes County,7669,7898,419,398,76,113,346,325,15567,152,838,671
25,9,25009,Massachusetts,Essex County,322368,348778,28026,28344,14477,16349,86496,89039,671146,28954,56052,175535
25,11,25011,Massachusetts,Franklin County,31981,33831,639,505,576,622,1602,1345,65812,1152,1278,2947
25,13,25013,Massachusetts,Hampden County,186495,198908,24393,26372,5912,6838,59092,63720,385403,11824,48786,122812
25,15,25015,Massachusetts,Hampshire County,66166,75364,2786,2756,3891,5277,4427,5003,141530,7782,5572,9430
25,17,25017,Massachusetts,Middlesex County,616722,643317,46949,48654,103098,107686,67829,66343,1260039,206196,93898,134172
25,19,25019,Massachusetts,Nantucket County,4858,4742,730,554,102,130,949,778,9600,204,1460,1727
25,21,25021,Massachusetts,Norfolk County,264130,284056,27536,29306,40242,44450,17388,17708,548186,80484,55072,35096
25,23,25023,Massachusetts,Plymouth County,213365,225410,29668,31351,3722,4720,11171,10568,438775,7444,59336,21739
25,25,25025,Massachusetts,Suffolk County,243730,252487,91055,104552,34932,39975,93514,93946,496217,69864,182110,187460
25,27,25027,Massachusetts,Worcester County,350332,361381,25786,24794,21864,23038,50355,50738,711713,43728,51572,101093
26,1,26001,Michigan,Alcona County,5087,4987,24,33,10,32,88,79,10074,20,48,167
26,3,26003,Michigan,Alger County,4028,3682,652,13,21,20,86,70,7710,42,1304,156
26,5,26005,Michigan,Allegan County,55998,56029,987,847,424,582,4537,4342,112027,848,1974,8879
26,7,26007,Michigan,Alpena County,13563,13947,82,73,93,75,234,192,27510,186,164,426
26,9,26009,Michigan,Antrim County,11208,11301,45,45,36,41,298,287,22509,72,90,585
26,11,26011,Michigan,Arenac County,7220,7072,40,32,14,32,154,149,14292,28,80,303
26,13,26013,Michigan,Baraga County,3111,2861,632,21,15,18,75,61,5972,30,1264,136
26,15,26015,Michigan,Barry County,29964,29464,236,167,154,176,983,950,59428,308,472,1933
26,17,26017,Michigan,Bay County,47811,49716,1050,841,268,357,2831,2849,97527,536,2100,5680
26,19,26019,Michigan,Benzie County,8484,8533,71,51,36,53,230,218,17017,72,142,448
26,21,26021,Michigan,Berrien County,60174,62062,10748,11973,1552,1699,4542,4287,122236,3104,21496,8829
26,23,26023,Michigan,Branch County,20886,20240,916,111,138,162,1196,1008,41126,276,1832,2204
26,25,26025,Michigan,Calhoun County,53371,55853,7538,7495,1889,2094,3740,3605,109224,3778,15076,7345
26,27,26027,Michigan,Cass County,23234,23221,1443,1248,161,240,1167,947,46455,322,2886,2114
26,29,26029,Michigan,Charlevoix County,12314,12579,74,51,66,94,281,297,24893,132,148,578
26,31,26031,Michigan,Cheboygan County,11729,11744,115,74,39,71,206,170,23473,78,230,376
26,33,26033,Michigan,Chippewa County,14092,12245,2485,118,151,170,384,359,26337,302,4970,743
26,35,26035,Michigan,Clare County,14895,14952,159,77,36,57,325,326,29847,72,318,651
26,37,26037,Michigan,Clinton County,36716,37792,883,822,602,700,1858,1819,74508,1204,1766,3677
26,39,26039,Michigan,Crawford County,6877,6590,74,51,46,72,148,164,13467,92,148,312
26,41,26041,Michigan,Delta County,16628,16883,85,58,77,100,295,263,33511,154,170,558
26,43,26043,Michigan,Dickinson County,12198,12081,73,64,77,94,233,203,24279,154,146,436
26,45,26045,Michigan,Eaton County,47108,48961,3894,4030,1457,1305,3121,3126,96069,2914,7788,6247
26,47,26047,Michigan,Emmet County,15235,15649,147,103,88,120,307,300,30884,176,294,607
26,49,26049,Michigan,Genesee County,148808,156767,38257,44071,1907,2261,7148,7341,305575,3814,76514,14489
26,51,26051,Michigan,Gladwin County,12491,12225,87,52,46,72,266,232,24716,92,174,498
26,53,26053,Michigan,Gogebic County,6644,6437,53,34,19,49,137,114,13081,38,106,251
26,55,26055,Michigan,Grand Traverse County,43143,45364,456,266,308,433,1420,1339,88507,616,912,2759
26,57,26057,Michigan,Gratiot County,18978,18116,2403,119,86,130,1414,1166,37094,172,4806,2580
26,59,26059,Michigan,Hillsdale County,22020,22060,184,133,97,132,577,528,44080,194,368,1105
26,61,26061,Michigan,Houghton County,17928,15454,217,116,650,405,382,257,33382,1300,434,639
26,63,26063,Michigan,Huron County,14956,15196,103,101,88,118,422,384,30152,176,206,806
26,65,26065,Michigan,Ingham County,107232,113839,17852,18518,10311,10218,11612,11769,221071,20622,35704,23381
26,67,26067,Michigan,Ionia County,30972,28754,2976,152,161,152,1835,1292,59726,322,5952,3127
26,69,26069,Michigan,Iosco County,11843,12093,125,84,92,116,340,310,23936,184,250,650
26,71,26071,Michigan,Iron County,5302,5302,30,17,11,40,109,152,10604,22,60,261
26,73,26073,Michigan,Isabella County,29935,31617,893,971,588,689,1438,1451,61552,1176,1786,2889
26,75,26075,Michigan,Jackson County,69832,69029,7830,5084,667,786,3065,2710,138861,1334,15660,5775
26,77,26077,Michigan,Kalamazoo County,105372,109824,15226,16116,3619,3867,6955,6868,215196,7238,30452,13823
26,79,26079,Michigan,Kalkaska County,8789,8454,84,46,50,54,205,188,17243,100,168,393
26,81,26081,Michigan,Kent County,266497,273653,34370,35225,10568,11359,36245,34995,540150,21136,68740,71240
26,83,26083,Michigan,Keweenaw County,1061,997,2,6,0,2,14,22,2058,0,4,36
26,85,26085,Michigan,Lake County,5282,5131,469,475,10,29,143,150,10413,20,938,293
26,87,26087,Michigan,Lapeer County,42456,41734,864,197,232,360,2109,2021,84190,464,1728,4130
26,89,26089,Michigan,Leelanau County,10029,10207,71,94,61,77,492,488,20236,122,142,980
26,91,26091,Michigan,Lenawee County,46005,46260,2086,823,197,294,4117,3932,92265,394,4172,8049
26,93,26093,Michigan,Livingston County,92735,92301,765,534,761,1126,2483,2414,185036,1522,1530,4897
26,95,26095,Michigan,Luce County,2653,2231,738,10,10,5,59,48,4884,20,1476,107
26,97,26097,Michigan,Mackinac County,4053,3940,202,175,52,44,102,111,7993,104,404,213
26,99,26099,Michigan,Macomb County,345126,356426,50103,59978,18118,19079,12325,11759,701552,36236,100206,24084
26,101,26101,Michigan,Manistee County,11261,11224,771,70,41,58,419,441,22485,82,1542,860
26,103,26103,Michigan,Marquette County,31026,31131,948,219,163,409,545,507,62157,326,1896,1052
26,105,26105,Michigan,Mason County,13753,14063,149,115,107,98,694,661,27816,214,298,1355
26,107,26107,Michigan,Mecosta County,20276,20110,627,624,200,190,557,496,40386,400,1254,1053
26,109,26109,Michigan,Menominee County,10848,10570,92,60,46,62,223,233,21418,92,184,456
26,111,26111,Michigan,Midland County,38534,39436,702,509,904,1073,1284,1150,77970,1808,1404,2434
26,113,26113,Michigan,Missaukee County,7346,7195,52,36,44,55,251,210,14541,88,104,461
26,115,26115,Michigan,Monroe County,69972,71970,2015,1983,477,559,2848,2793,141942,954,4030,5641
26,117,26117,Michigan,Montcalm County,30711,29827,1452,142,116,156,1267,1047,60538,232,2904,2314
26,119,26119,Michigan,Montmorency County,4609,4404,33,20,7,19,71,60,9013,14,66,131
26,121,26121,Michigan,Muskegon County,69888,71004,12026,12204,465,733,5106,4973,140892,930,24052,10079
26,123,26123,Michigan,Newaygo County,23496,23320,381,222,114,138,1529,1390,46816,228,762,2919
26,125,26125,Michigan,Oakland County,469107,477499,78644,96706,52736,49790,27323,27215,946606,105472,157288,54538
26,127,26127,Michigan,Oceana County,12694,12460,201,144,34,43,2135,1850,25154,68,402,3985
26,129,26129,Michigan,Ogemaw County,10087,10137,48,38,69,64,250,240,20224,138,96,490
26,131,26131,Michigan,Ontonagon County,2826,2663,11,8,14,19,44,47,5489,28,22,91
26,133,26133,Michigan,Osceola County,11325,11230,115,80,32,39,277,254,22555,64,230,531
26,135,26135,Michigan,Oscoda County,4072,3896,23,19,6,11,80,72,7968,12,46,152
26,137,26137,Michigan,Otsego County,11748,11898,87,59,59,108,191,272,23646,118,174,463
26,139,26139,Michigan,Ottawa County,133415,136679,3042,2493,4026,4592,15424,14304,270094,8052,6084,29728
26,141,26141,Michigan,Presque Isle County,6058,6099,44,37,33,47,95,99,12157,66,88,194
26,143,26143,Michigan,Roscommon County,11573,11522,80,77,79,87,255,247,23095,158,160,502
26,145,26145,Michigan,Saginaw County,70956,74349,17453,19274,1339,1373,8031,8486,145305,2678,34906,16517
26,147,26147,Michigan,St. Clair County,74301,75264,2158,1920,412,569,2843,2737,149565,824,4316,5580
26,149,26149,Michigan,St. Joseph County,28576,28579,792,718,188,223,2654,2474,57155,376,1584,5128
26,151,26151,Michigan,Sanilac County,19913,20061,152,87,74,95,855,702,39974,148,304,1557
26,153,26153,Michigan,Schoolcraft County,3430,3550,16,18,10,11,58,49,6980,20,32,107
26,155,26155,Michigan,Shiawassee County,32503,33172,316,213,154,207,1068,1034,65675,308,632,2102
26,157,26157,Michigan,Tuscola County,25238,25041,457,238,77,105,963,910,50279,154,914,1873
26,159,26159,Michigan,Van Buren County,34364,34868,1493,1497,213,310,4634,4197,69232,426,2986,8831
26,161,26161,Michigan,Washtenaw County,135285,137616,22299,22957,17196,17273,8961,9114,272901,34392,44598,18075
26,163,26163,Michigan,Wayne County,473084,482297,312553,364953,30288,31496,54288,53163,955381,60576,625106,107451
26,165,26165,Michigan,Wexford County,16119,16111,145,79,116,113,373,337,32230,232,290,710
27,1,27001,Minnesota,Aitkin County,7639,7416,55,36,19,28,117,109,15055,38,110,226
27,3,27003,Minnesota,Anoka County,149698,149281,13450,12886,8511,9248,9056,8314,298979,17022,26900,17370
27,5,27005,Minnesota,Becker County,15049,14983,133,93,81,105,372,409,30032,162,266,781
27,7,27007,Minnesota,Beltrami County,17157,17225,252,156,141,216,667,549,34382,282,504,1216
27,9,27009,Minnesota,Benton County,18512,18623,1156,968,208,260,607,518,37135,416,2312,1125
27,11,27011,Minnesota,Big Stone County,2419,2437,17,8,6,9,63,41,4856,12,34,104
27,13,27013,Minnesota,Blue Earth County,30626,30625,1556,1376,896,785,1502,1162,61251,1792,3112,2664
27,15,27015,Minnesota,Brown County,12119,12248,88,46,125,96,572,589,24367,250,176,1161
27,17,27017,Minnesota,Carlton County,16442,15497,554,60,112,89,389,264,31939,224,1108,653
27,19,27019,Minnesota,Carver County,48194,48647,1181,1175,1608,1913,2306,2267,96841,3216,2362,4573
27,21,27021,Minnesota,Cass County,12894,12230,63,69,58,71,375,310,25124,116,126,685
27,23,27023,Minnesota,Chippewa County,5509,5497,65,46,57,68,542,412,11006,114,130,954
27,25,27025,Minnesota,Chisago County,27366,26279,643,147,353,422,775,574,53645,706,1286,1349
27,27,27027,Minnesota,Clay County,28434,29211,1527,1311,463,465,1506,1486,57645,926,3054,2992
27,29,27029,Minnesota,Clearwater County,3826,3725,43,27,8,20,120,95,7551,16,86,215
27,31,27031,Minnesota,Cook County,2356,2348,33,42,19,33,57,73,4704,38,66,130
27,33,27033,Minnesota,Cottonwood County,5098,5124,89,62,230,234,460,475,10222,460,178,935
27,35,27035,Minnesota,Crow Wing County,31017,31391,321,235,115,200,508,493,62408,230,642,1001
27,37,27037,Minnesota,Dakota County,176765,181991,16535,15592,10627,11766,16572,15853,358756,21254,33070,32425
27,39,27039,Minnesota,Dodge County,10117,10055,93,64,49,118,552,474,20172,98,186,1026
27,41,27041,Minnesota,Douglas County,18531,18536,140,114,89,109,352,315,37067,178,280,667
27,43,27043,Minnesota,Faribault County,6629,6531,69,53,18,37,521,480,13160,36,138,1001
27,45,27045,Minnesota,Fillmore County,10339,10208,69,45,38,105,240,142,20547,76,138,382
27,47,27047,Minnesota,Freeborn County,13998,14193,263,223,485,428,1578,1522,28191,970,526,3100
27,49,27049,Minnesota,Goodhue County,21677,22076,391,299,148,202,809,776,43753,296,782,1585
27,51,27051,Minnesota,Grant County,2934,2837,18,20,6,16,62,76,5771,12,36,138
27,53,27053,Minnesota,Hennepin County,464899,474601,86984,88118,47298,48010,46068,42405,939500,94596,173968,88473
27,55,27055,Minnesota,Houston County,9027,8964,87,51,60,74,111,116,17991,120,174,227
27,57,27057,Minnesota,Hubbard County,10214,9955,75,38,44,79,294,215,20169,88,150,509
27,59,27059,Minnesota,Isanti County,19517,19123,215,180,219,282,461,447,38640,438,430,908
27,61,27061,Minnesota,Itasca County,21081,20695,154,85,58,105,339,394,41776,116,308,733
27,63,27063,Minnesota,Jackson County,4785,4587,41,40,86,84,239,170,9372,172,82,409
27,65,27065,Minnesota,Kanabec County,7862,7782,58,39,57,63,128,148,15644,114,116,276
27,67,27067,Minnesota,Kandiyohi County,19481,19453,1605,1303,257,264,2830,2614,38934,514,3210,5444
27,69,27069,Minnesota,Kittson County,2082,2080,8,23,13,18,59,48,4162,26,16,107
27,71,27071,Minnesota,Koochiching County,5779,5733,49,37,14,63,83,77,11512,28,98,160
27,73,27073,Minnesota,Lac qui Parle County,3187,3193,41,15,25,33,90,74,6380,50,82,164
27,75,27075,Minnesota,Lake County,5271,5011,53,15,27,37,83,70,10282,54,106,153
27,77,27077,Minnesota,Lake of the Woods County,1862,1656,16,11,21,41,27,37,3518,42,32,64
27,79,27079,Minnesota,Le Sueur County,14107,13811,137,109,84,113,975,981,27918,168,274,1956
27,81,27081,Minnesota,Lincoln County,2768,2727,9,6,15,16,77,55,5495,30,18,132
27,83,27083,Minnesota,Lyon County,11279,11540,483,376,638,565,914,918,22819,1276,966,1832
27,85,27085,Minnesota,McLeod County,17312,17348,172,125,143,142,1231,1151,34660,286,344,2382
27,87,27087,Minnesota,Mahnomen County,1301,1250,19,20,5,1,136,99,2551,10,38,235
27,89,27089,Minnesota,Marshall County,4566,4487,22,22,14,22,229,207,9053,28,44,436
27,91,27091,Minnesota,Martin County,9388,9629,109,61,61,70,506,473,19017,122,218,979
27,93,27093,Minnesota,Meeker County,11475,11112,116,68,35,66,485,505,22587,70,232,990
27,95,27095,Minnesota,Mille Lacs County,12002,11724,97,75,76,99,347,340,23726,152,194,687
27,97,27097,Minnesota,Morrison County,16327,16083,156,149,59,72,295,323,32410,118,312,618
27,99,27099,Minnesota,Mower County,17513,17659,925,624,1103,1007,2587,2310,35172,2206,1850,4897
27,101,27101,Minnesota,Murray County,3916,3937,27,17,63,70,186,171,7853,126,54,357
27,103,27103,Minnesota,Nicollet County,15943,15662,686,646,265,294,916,775,31605,530,1372,1691
27,105,27105,Minnesota,Nobles County,9331,9045,619,429,828,735,3353,3001,18376,1656,1238,6354
27,107,27107,Minnesota,Norman County,2980,2964,30,30,21,25,170,155,5944,42,60,325
27,109,27109,Minnesota,Olmsted County,64385,67925,5492,5399,5040,5390,4423,3796,132310,10080,10984,8219
27,111,27111,Minnesota,Otter Tail County,28165,27828,551,426,152,221,1135,1015,55993,304,1102,2150
27,113,27113,Minnesota,Pennington County,6539,6647,115,65,60,73,306,279,13186,120,230,585
27,115,27115,Minnesota,Pine County,14265,12756,587,79,125,120,581,313,27021,250,1174,894
27,117,27117,Minnesota,Pipestone County,4138,4278,93,76,50,55,325,370,8416,100,186,695
27,119,27119,Minnesota,Polk County,14414,14333,540,446,162,158,1052,1022,28747,324,1080,2074
27,121,27121,Minnesota,Pope County,5568,5347,26,27,34,39,108,115,10915,68,52,223
27,123,27123,Minnesota,Ramsey County,179012,190058,35270,35676,41693,42484,20986,20363,369070,83386,70540,41349
27,125,27125,Minnesota,Red Lake County,1978,1859,14,13,3,13,90,77,3837,6,28,167
27,127,27127,Minnesota,Redwood County,6745,6746,93,73,215,185,297,280,13491,430,186,577
27,129,27129,Minnesota,Renville County,7064,6823,53,35,64,60,674,632,13887,128,106,1306
27,131,27131,Minnesota,Rice County,30092,29504,2511,1632,688,811,3048,2641,59596,1376,5022,5689
27,133,27133,Minnesota,Rock County,4388,4536,50,32,39,39,167,160,8924,78,100,327
27,135,27135,Minnesota,Roseau County,7263,6778,54,46,209,216,123,99,14041,418,108,222
27,137,27137,Minnesota,St. Louis County,91770,91822,1963,1353,1038,1236,1849,1762,183592,2076,3926,3611
27,139,27139,Minnesota,Scott County,62833,63118,4034,4004,4598,4977,4079,3805,125951,9196,8068,7884
27,141,27141,Minnesota,Sherburne County,46109,44174,1817,1247,556,673,1502,1188,90283,1112,3634,2690
27,143,27143,Minnesota,Sibley County,7255,7090,79,45,48,59,728,655,14345,96,158,1383
27,145,27145,Minnesota,Stearns County,70666,70341,6627,5877,1863,1927,3035,2702,141007,3726,13254,5737
27,147,27147,Minnesota,Steele County,16977,17228,710,579,173,227,1527,1469,34205,346,1420,2996
27,149,27149,Minnesota,Stevens County,4561,4483,65,61,95,116,478,276,9044,190,130,754
27,151,27151,Minnesota,Swift County,4402,4362,60,55,23,28,252,232,8764,46,120,484
27,153,27153,Minnesota,Todd County,12258,11482,95,75,55,76,894,794,23740,110,190,1688
27,155,27155,Minnesota,Traverse County,1464,1463,12,10,13,4,85,44,2927,26,24,129
27,157,27157,Minnesota,Wabasha County,10559,10461,75,66,61,78,345,309,21020,122,150,654
27,159,27159,Minnesota,Wadena County,6480,6580,91,66,23,50,130,161,13060,46,182,291
27,161,27161,Minnesota,Waseca County,8594,8990,146,278,83,79,532,654,17584,166,292,1186
27,163,27163,Minnesota,Washington County,110448,113684,7031,6186,8112,8756,6014,5688,224132,16224,14062,11702
27,165,27165,Minnesota,Watonwan County,5125,5236,69,65,59,64,1432,1503,10361,118,138,2935
27,167,27167,Minnesota,Wilkin County,3067,2848,24,13,14,16,114,77,5915,28,48,191
27,169,27169,Minnesota,Winona County,23398,23908,476,454,657,674,854,703,47306,1314,952,1557
27,171,27171,Minnesota,Wright County,66081,64540,1314,1214,910,1081,2256,2070,130621,1820,2628,4326
27,173,27173,Minnesota,Yellow Medicine County,4542,4473,46,38,24,31,261,238,9015,48,92,499
28,1,28001,Mississippi,Adams County,7943,5688,7637,8766,90,88,2849,250,13631,180,15274,3099
28,3,28003,Mississippi,Alcorn County,15407,16185,2222,2358,64,81,684,505,31592,128,4444,1189
28,5,28005,Mississippi,Amite County,3507,3701,2342,2573,7,13,94,72,7208,14,4684,166
28,7,28007,Mississippi,Attala County,4871,5053,3568,4361,34,45,185,180,9924,68,7136,365
28,9,28009,Mississippi,Benton County,2559,2576,1442,1514,2,6,117,101,5135,4,2884,218
28,11,28011,Mississippi,Bolivar County,5072,5391,8857,10667,192,154,353,331,10463,384,17714,684
28,13,28013,Mississippi,Calhoun County,4913,5097,1870,2224,8,15,512,390,10010,16,3740,902
28,15,28015,Mississippi,Carroll County,3310,3192,1627,1655,10,15,89,74,6502,20,3254,163
28,17,28017,Mississippi,Chickasaw County,4523,4496,3663,3960,41,45,556,365,9019,82,7326,921
28,19,28019,Mississippi,Choctaw County,2762,2833,1150,1287,19,12,74,57,5595,38,2300,131
28,21,28021,Mississippi,Claiborne County,517,505,3652,4131,30,40,81,43,1022,60,7304,124
28,23,28023,Mississippi,Clarke County,4798,5124,2406,2992,9,26,78,96,9922,18,4812,174
28,25,28025,Mississippi,Clay County,3710,3885,5195,6254,42,32,168,138,7595,84,10390,306
28,27,28027,Mississippi,Coahoma County,2243,2383,7839,9327,57,52,195,172,4626,114,15678,367
28,29,28029,Mississippi,Copiah County,6352,6652,6871,7702,56,49,504,430,13004,112,13742,934
28,31,28031,Mississippi,Covington County,5770,5779,3150,3584,37,43,284,163,11549,74,6300,447
28,33,28033,Mississippi,DeSoto County,60433,62389,25447,30189,1357,1650,4935,4480,122822,2714,50894,9415
28,35,28035,Mississippi,Forrest County,21567,22777,12689,15625,409,431,1173,1051,44344,818,25378,2224
28,37,28037,Mississippi,Franklin County,2443,2464,1280,1384,3,5,50,39,4907,6,2560,89
28,39,28039,Mississippi,George County,11088,10885,1050,846,37,161,438,307,21973,74,2100,745
28,41,28041,Mississippi,Greene County,5276,4672,2485,962,9,14,111,58,9948,18,4970,169
28,43,28043,Mississippi,Grenada County,5568,5904,4101,4800,55,41,178,155,11472,110,8202,333
28,45,28045,Mississippi,Hancock County,20464,21309,1919,2063,197,246,915,919,41773,394,3838,1834
28,47,28047,Mississippi,Harrison County,70129,71036,25288,28656,2689,3314,6019,5581,141165,5378,50576,11600
28,49,28049,Mississippi,Hinds County,28054,30075,78264,91269,723,996,1791,1822,58129,1446,156528,3613
28,51,28051,Mississippi,Holmes County,1364,1308,6622,7507,22,22,97,105,2672,44,13244,202
28,53,28053,Mississippi,Humphreys County,912,889,2820,3290,16,16,178,129,1801,32,5640,307
28,55,28055,Mississippi,Issaquena County,237,226,549,297,5,1,11,11,463,10,1098,22
28,57,28057,Mississippi,Itawamba County,10482,10804,854,773,63,60,212,186,21286,126,1708,398
28,59,28059,Mississippi,Jackson County,52234,52966,14745,16414,1593,1785,5258,4552,105200,3186,29490,9810
28,61,28061,Mississippi,Jasper County,3674,3776,4152,4560,9,14,132,105,7450,18,8304,237
28,63,28063,Mississippi,Jefferson County,493,440,2905,3065,7,4,33,30,933,14,5810,63
28,65,28065,Mississippi,Jefferson Davis County,2117,2205,3058,3573,19,15,104,108,4322,38,6116,212
28,67,28067,Mississippi,Jones County,22882,23465,9486,10750,145,191,1745,1452,46347,290,18972,3197
28,69,28069,Mississippi,Kemper County,1659,1666,3024,2955,4,15,46,46,3325,8,6048,92
28,71,28071,Mississippi,Lafayette County,19301,19797,5830,6979,614,568,714,728,39098,1228,11660,1442
28,73,28073,Mississippi,Lamar County,23351,24571,6019,7273,425,547,922,922,47922,850,12038,1844
28,75,28075,Mississippi,Lauderdale County,19673,20045,15445,17311,267,291,883,810,39718,534,30890,1693
28,77,28077,Mississippi,Lawrence County,4094,4208,1892,2187,28,24,180,94,8302,56,3784,274
28,79,28079,Mississippi,Leake County,5672,5588,5123,4480,63,54,615,490,11260,126,10246,1105
28,81,28081,Mississippi,Lee County,27633,29459,12077,14037,384,443,1278,1056,57092,768,24154,2334
28,83,28083,Mississippi,Leflore County,3168,3351,9676,11459,100,72,431,363,6519,200,19352,794
28,85,28085,Mississippi,Lincoln County,11289,11902,4754,5589,66,79,245,215,23191,132,9508,460
28,87,28087,Mississippi,Lowndes County,15320,15607,11920,14305,269,331,674,542,30927,538,23840,1216
28,89,28089,Mississippi,Madison County,29892,31179,18690,21993,1455,1502,1645,1689,61071,2910,37380,3334
28,91,28091,Mississippi,Marion County,7935,8405,3766,3994,42,48,241,192,16340,84,7532,433
28,93,28093,Mississippi,Marshall County,9067,8964,8084,8524,41,62,772,629,18031,82,16168,1401
28,95,28095,Mississippi,Monroe County,11556,12424,4986,5757,40,56,277,200,23980,80,9972,477
28,97,28097,Mississippi,Montgomery County,2535,2666,2048,2327,51,23,68,76,5201,102,4096,144
28,99,28099,Mississippi,Neshoba County,8258,8876,2826,3369,69,61,329,321,17134,138,5652,650
28,101,28101,Mississippi,Newton County,6362,6576,2947,3619,48,57,222,188,12938,96,5894,410
28,103,28103,Mississippi,Noxubee County,1319,1467,3519,3962,10,17,77,75,2786,20,7038,152
28,105,28105,Mississippi,Oktibbeha County,14895,13616,8496,10134,935,705,412,447,28511,1870,16992,859
28,107,28107,Mississippi,Panola County,8071,8426,8045,9069,31,38,360,398,16497,62,16090,758
28,109,28109,Mississippi,Pearl River County,23085,23815,3320,3519,109,134,927,878,46900,218,6640,1805
28,111,28111,Mississippi,Perry County,4637,4794,1106,1193,13,12,98,89,9431,26,2212,187
28,113,28113,Mississippi,Pike County,8298,8920,9873,11379,151,122,320,309,17218,302,19746,629
28,115,28115,Mississippi,Pontotoc County,12859,13448,2418,2614,73,65,1219,1128,26307,146,4836,2347
28,117,28117,Mississippi,Prentiss County,10284,10741,1787,1816,28,40,197,200,21025,56,3574,397
28,119,28119,Mississippi,Quitman County,854,943,2236,2632,11,5,69,55,1797,22,4472,124
28,121,28121,Mississippi,Rankin County,56520,60764,16072,17395,955,1207,2252,2129,117284,1910,32144,4381
28,123,28123,Mississippi,Scott County,8275,8096,5071,5791,76,86,1911,1424,16371,152,10142,3335
28,125,28125,Mississippi,Sharkey County,605,582,1424,1642,15,12,59,39,1187,30,2848,98
28,127,28127,Mississippi,Simpson County,8209,8496,4406,4967,69,80,294,208,16705,138,8812,502
28,129,28129,Mississippi,Smith County,5850,6134,1758,2009,8,13,150,142,11984,16,3516,292
28,131,28131,Mississippi,Stone County,7210,7167,1768,1730,32,50,198,183,14377,64,3536,381
28,133,28133,Mississippi,Sunflower County,3459,2743,9748,8789,52,54,268,225,6202,104,19496,493
28,135,28135,Mississippi,Tallahatchie County,3362,2194,4013,3854,118,23,892,59,5556,236,8026,951
28,137,28137,Mississippi,Tate County,9329,9685,4007,4743,43,55,434,347,19014,86,8014,781
28,139,28139,Mississippi,Tippah County,8719,9090,1758,1929,25,37,534,531,17809,50,3516,1065
28,141,28141,Mississippi,Tishomingo County,9034,9546,258,235,17,24,321,344,18580,34,516,665
28,143,28143,Mississippi,Tunica County,1002,940,3400,4074,42,32,131,110,1942,84,6800,241
28,145,28145,Mississippi,Union County,11497,11936,2084,2343,202,130,717,568,23433,404,4168,1285
28,147,28147,Mississippi,Walthall County,3804,3956,2934,3231,34,40,142,169,7760,68,5868,311
28,149,28149,Mississippi,Warren County,10817,11158,10306,12051,174,213,494,508,21975,348,20612,1002
28,151,28151,Mississippi,Washington County,5555,5764,14304,17478,164,179,411,350,11319,328,28608,761
28,153,28153,Mississippi,Wayne County,5812,6007,3739,4297,20,32,187,135,11819,40,7478,322
28,155,28155,Mississippi,Webster County,3766,3949,882,933,6,10,76,69,7715,12,1764,145
28,157,28157,Mississippi,Wilkinson County,1335,1097,3258,2835,7,3,47,42,2432,14,6516,89
28,159,28159,Mississippi,Winston County,4518,4577,4045,4359,33,22,142,107,9095,66,8090,249
28,161,28161,Mississippi,Yalobusha County,3472,3704,2226,2480,8,19,103,104,7176,16,4452,207
28,163,28163,Mississippi,Yazoo County,7486,4535,9760,7207,111,64,2386,147,12021,222,19520,2533
29,1,29001,Missouri,Adair County,11161,12037,445,411,266,398,312,341,23198,532,890,653
29,3,29003,Missouri,Andrew County,8415,8637,119,86,50,59,259,216,17052,100,238,475
29,5,29005,Missouri,Atchison County,2501,2508,18,8,13,7,37,39,5009,26,36,76
29,7,29007,Missouri,Audrain County,10570,12258,664,1081,86,49,459,369,22828,172,1328,828
29,9,29009,Missouri,Barry County,16759,16680,125,114,456,412,1909,1648,33439,912,250,3557
29,11,29011,Missouri,Barton County,5450,5661,46,28,17,49,187,151,11111,34,92,338
29,13,29013,Missouri,Bates County,7650,7808,140,64,20,25,197,175,15458,40,280,372
29,15,29015,Missouri,Benton County,9379,9342,68,44,28,59,226,190,18721,56,136,416
29,17,29017,Missouri,Bollinger County,5889,5882,40,29,12,16,104,75,11771,24,80,179
29,19,29019,Missouri,Boone County,71156,75704,8596,9124,4358,4710,3238,3149,146860,8716,17192,6387
29,21,29021,Missouri,Buchanan County,38499,38809,3276,1941,647,658,3270,2721,77308,1294,6552,5991
29,23,29023,Missouri,Butler County,18579,19696,1189,1193,154,231,501,437,38275,308,2378,938
29,25,29025,Missouri,Caldwell County,4386,4276,47,17,10,20,129,95,8662,20,94,224
29,27,29027,Missouri,Callaway County,20849,20191,1258,827,132,221,527,446,41040,264,2516,973
29,29,29029,Missouri,Camden County,22160,22479,173,138,118,200,651,669,44639,236,346,1320
29,31,29031,Missouri,Cape Girardeau County,33404,35585,2953,3273,730,804,997,950,68989,1460,5906,1947
29,33,29033,Missouri,Carroll County,4042,4282,84,75,4,12,81,61,8324,8,168,142
29,35,29035,Missouri,Carter County,2793,2933,17,15,2,7,65,107,5726,4,34,172
29,37,29037,Missouri,Cass County,46973,49462,2393,2422,413,516,2457,2385,96435,826,4786,4842
29,39,29039,Missouri,Cedar County,6859,6933,40,27,22,42,188,165,13792,44,80,353
29,41,29041,Missouri,Chariton County,3533,3556,96,81,9,16,40,25,7089,18,192,65
29,43,29043,Missouri,Christian County,41445,43231,478,306,255,382,1420,1343,84676,510,956,2763
29,45,29045,Missouri,Clark County,3395,3238,17,11,13,16,35,24,6633,26,34,59
29,47,29047,Missouri,Clay County,105577,109937,9199,9028,2961,3326,8942,8719,215514,5922,18398,17661
29,49,29049,Missouri,Clinton County,9705,9724,166,122,38,64,240,232,19429,76,332,472
29,51,29051,Missouri,Cole County,31843,32404,5385,3993,507,575,1162,1089,64247,1014,10770,2251
29,53,29053,Missouri,Cooper County,8002,7770,925,318,46,71,147,227,15772,92,1850,374
29,55,29055,Missouri,Crawford County,11521,11629,72,52,31,45,245,261,23150,62,144,506
29,57,29057,Missouri,Dade County,3656,3531,30,10,27,18,85,88,7187,54,60,173
29,59,29059,Missouri,Dallas County,8042,8190,48,26,18,48,200,178,16232,36,96,378
29,61,29061,Missouri,Daviess County,4038,4004,30,29,7,15,62,55,8042,14,60,117
29,63,29063,Missouri,DeKalb County,6242,4531,1447,36,19,30,241,120,10773,38,2894,361
29,65,29065,Missouri,Dent County,7433,7437,57,48,23,97,150,148,14870,46,114,298
29,67,29067,Missouri,Douglas County,6347,6319,29,31,17,27,128,106,12666,34,58,234
29,69,29069,Missouri,Dunklin County,12020,12995,1457,1639,110,155,1023,1008,25015,220,2914,2031
29,71,29071,Missouri,Franklin County,49754,50610,610,427,257,316,1015,921,100364,514,1220,1936
29,73,29073,Missouri,Gasconade County,7131,7154,59,24,26,37,131,108,14285,52,118,239
29,75,29075,Missouri,Gentry County,3065,3309,23,19,17,12,56,67,6374,34,46,123
29,77,29077,Missouri,Greene County,128108,136613,5642,4471,2912,3784,5944,5632,264721,5824,11284,11576
29,79,29079,Missouri,Grundy County,4601,4844,59,39,40,73,123,112,9445,80,118,235
29,81,29081,Missouri,Harrison County,4005,4077,28,22,19,14,129,92,8082,38,56,221
29,83,29083,Missouri,Henry County,10251,10588,140,123,43,47,268,298,20839,86,280,566
29,85,29085,Missouri,Hickory County,4535,4624,28,31,9,15,113,82,9159,18,56,195
29,87,29087,Missouri,Holt County,2077,2173,14,7,5,11,28,41,4250,10,28,69
29,89,29089,Missouri,Howard County,4574,4565,271,247,11,22,88,81,9139,22,542,169
29,91,29091,Missouri,Howell County,18768,19730,138,97,88,209,434,456,38498,176,276,890
29,93,29093,Missouri,Iron County,4794,4891,86,62,7,8,100,91,9685,14,172,191
29,95,29095,Missouri,Jackson County,241899,251343,77273,89612,6519,7304,32696,32290,493242,13038,154546,64986
29,97,29097,Missouri,Jasper County,53550,56459,1549,1259,725,794,5239,5031,110009,1450,3098,10270
29,99,29099,Missouri,Jefferson County,107265,108758,1480,1169,785,1054,2420,2284,216023,1570,2960,4704
29,101,29101,Missouri,Johnson County,24559,23749,1499,1205,541,439,1362,1234,48308,1082,2998,2596
29,103,29103,Missouri,Knox County,1918,1910,10,13,8,9,27,29,3828,16,20,56
29,105,29105,Missouri,Laclede County,16719,17387,188,136,80,141,446,472,34106,160,376,918
29,107,29107,Missouri,Lafayette County,15247,15566,403,312,75,99,577,447,30813,150,806,1024
29,109,29109,Missouri,Lawrence County,18164,18413,143,107,93,118,1589,1444,36577,186,286,3033
29,111,29111,Missouri,Lewis County,4624,4577,163,146,19,23,93,89,9201,38,326,182
29,113,29113,Missouri,Lincoln County,28014,28103,691,493,103,204,802,755,56117,206,1382,1557
29,115,29115,Missouri,Linn County,5583,5936,63,48,21,16,166,172,11519,42,126,338
29,117,29117,Missouri,Livingston County,6316,7899,92,473,78,48,134,177,14215,156,184,311
29,119,29119,Missouri,McDonald County,9904,9867,259,209,188,170,1381,1222,19771,376,518,2603
29,121,29121,Missouri,Macon County,7051,7244,208,163,46,52,125,146,14295,92,416,271
29,123,29123,Missouri,Madison County,5707,5946,50,25,59,69,129,150,11653,118,100,279
29,125,29125,Missouri,Maries County,4210,4166,35,25,9,26,65,63,8376,18,70,128
29,127,29127,Missouri,Marion County,12650,13468,728,692,91,95,299,243,26118,182,1456,542
29,129,29129,Missouri,Mercer County,1768,1731,8,8,13,16,56,42,3499,26,16,98
29,131,29131,Missouri,Miller County,12285,12381,124,72,56,58,286,263,24666,112,248,549
29,133,29133,Missouri,Mississippi County,4943,4691,2056,1215,20,22,193,130,9634,40,4112,323
29,135,29135,Missouri,Moniteau County,7783,7288,609,55,32,38,493,367,15071,64,1218,860
29,137,29137,Missouri,Monroe County,4108,4012,148,106,13,21,77,66,8120,26,296,143
29,139,29139,Missouri,Montgomery County,5504,5527,145,71,16,39,169,75,11031,32,290,244
29,141,29141,Missouri,Morgan County,9905,9852,116,69,35,65,273,223,19757,70,232,496
29,143,29143,Missouri,New Madrid County,6762,7123,1222,1490,30,34,221,139,13885,60,2444,360
29,145,29145,Missouri,Newton County,26112,26532,339,267,395,486,1760,1487,52644,790,678,3247
29,147,29147,Missouri,Nodaway County,10249,10510,462,203,190,133,227,173,20759,380,924,400
29,149,29149,Missouri,Oregon County,4950,5093,15,28,8,27,101,102,10043,16,30,203
29,151,29151,Missouri,Osage County,6890,6474,34,24,12,12,57,63,13364,24,68,120
29,153,29153,Missouri,Ozark County,4423,4424,10,7,4,17,97,90,8847,8,20,187
29,155,29155,Missouri,Pemiscot County,5365,5780,1786,2341,41,34,247,200,11145,82,3572,447
29,157,29157,Missouri,Perry County,9173,9293,73,62,85,90,260,211,18466,170,146,471
29,159,29159,Missouri,Pettis County,19320,19726,761,675,177,197,1947,1767,39046,354,1522,3714
29,161,29161,Missouri,Phelps County,20861,19573,584,385,985,680,678,577,40434,1970,1168,1255
29,163,29163,Missouri,Pike County,8761,7702,1149,274,35,36,254,159,16463,70,2298,413
29,165,29165,Missouri,Platte County,44025,45479,4089,3857,1473,1601,3374,3252,89504,2946,8178,6626
29,167,29167,Missouri,Polk County,15063,15655,211,99,124,151,392,421,30718,248,422,813
29,169,29169,Missouri,Pulaski County,23145,18014,3914,2637,780,821,3679,2515,41159,1560,7828,6194
29,171,29171,Missouri,Putnam County,2325,2257,8,5,9,16,55,61,4582,18,16,116
29,173,29173,Missouri,Ralls County,4977,4959,87,59,13,15,69,69,9936,26,174,138
29,175,29175,Missouri,Randolph County,11416,10980,959,434,67,133,278,255,22396,134,1918,533
29,177,29177,Missouri,Ray County,10934,11044,219,130,39,47,310,285,21978,78,438,595
29,179,29179,Missouri,Reynolds County,3076,2856,49,28,1,11,56,50,5932,2,98,106
29,181,29181,Missouri,Ripley County,6340,6438,45,33,14,27,122,84,12778,28,90,206
29,183,29183,Missouri,St. Charles County,176999,183267,10450,10806,5216,5856,7091,6663,360266,10432,20900,13754
29,185,29185,Missouri,St. Clair County,4562,4486,45,24,8,19,111,103,9048,16,90,214
29,186,29186,Missouri,Ste. Genevieve County,8731,8567,108,47,20,30,101,123,17298,40,216,224
29,187,29187,Missouri,St. Francois County,32242,30224,2792,329,163,154,634,479,62466,326,5584,1113
29,189,29189,Missouri,St. Louis County,326179,348591,111073,137561,22709,23544,15100,14816,674770,45418,222146,29916
29,195,29195,Missouri,Saline County,10063,10177,689,537,107,118,1303,1169,20240,214,1378,2472
29,197,29197,Missouri,Schuyler County,2260,2306,3,3,6,8,37,44,4566,12,6,81
29,199,29199,Missouri,Scotland County,2376,2433,1,4,3,8,24,30,4809,6,2,54
29,201,29201,Missouri,Scott County,15911,16649,2131,2482,85,93,486,446,32560,170,4262,932
29,203,29203,Missouri,Shannon County,3881,3895,28,15,9,12,89,77,7776,18,56,166
29,205,29205,Missouri,Shelby County,2891,2863,30,25,3,7,68,61,5754,6,60,129
29,207,29207,Missouri,Stoddard County,13742,14313,215,151,36,70,296,238,28055,72,430,534
29,209,29209,Missouri,Stone County,15122,15700,87,48,41,87,412,355,30822,82,174,767
29,211,29211,Missouri,Sullivan County,2875,2798,133,64,20,14,644,487,5673,40,266,1131
29,213,29213,Missouri,Taney County,25233,27060,534,478,279,394,1764,1720,52293,558,1068,3484
29,215,29215,Missouri,Texas County,12002,11560,891,70,37,60,289,277,23562,74,1782,566
29,217,29217,Missouri,Vernon County,9627,10030,93,106,59,75,239,238,19657,118,186,477
29,219,29219,Missouri,Warren County,16795,16922,452,369,71,98,614,631,33717,142,904,1245
29,221,29221,Missouri,Washington County,11896,11643,538,74,34,41,211,164,23539,68,1076,375
29,223,29223,Missouri,Wayne County,6078,6274,66,49,14,22,118,113,12352,28,132,231
29,225,29225,Missouri,Webster County,19289,18610,369,88,56,87,452,406,37899,112,738,858
29,227,29227,Missouri,Worth County,944,1017,9,9,1,3,25,12,1961,2,18,37
29,229,29229,Missouri,Wright County,8656,8999,66,52,30,47,198,216,17655,60,132,414
29,510,29510,Missouri,St. Louis city,73316,71333,62408,73759,5285,5597,6780,5763,144649,10570,124816,12543
30,1,30001,Montana,Beaverhead County,4559,4364,24,15,15,32,315,205,8923,30,48,520
30,3,30003,Montana,Big Horn County,1998,1874,25,32,23,68,495,379,3872,46,50,874
30,5,30005,Montana,Blaine County,1526,1528,17,8,10,5,162,86,3054,20,34,248
30,7,30007,Montana,Broadwater County,3069,2907,25,10,6,12,90,93,5976,12,50,183
30,9,30009,Montana,Carbon County,5195,5107,39,24,13,24,126,135,10302,26,78,261
30,11,30011,Montana,Carter County,603,608,2,1,0,1,7,7,1211,0,4,14
30,13,30013,Montana,Cascade County,36301,35638,839,509,365,468,2052,1808,71939,730,1678,3860
30,15,30015,Montana,Chouteau County,2260,2160,6,7,9,15,82,79,4420,18,12,161
30,17,30017,Montana,Custer County,5357,5367,40,27,29,54,197,229,10724,58,80,426
30,19,30019,Montana,Daniels County,818,774,6,1,0,3,34,20,1592,0,12,54
30,21,30021,Montana,Dawson County,4187,3949,31,9,18,35,134,127,8136,36,62,261
30,23,30023,Montana,Deer Lodge County,4468,3957,27,19,21,24,212,126,8425,42,54,338
30,25,30025,Montana,Fallon County,1396,1344,2,3,11,10,27,19,2740,22,4,46
30,27,30027,Montana,Fergus County,5411,5140,17,21,9,45,110,133,10551,18,34,243
30,29,30029,Montana,Flathead County,49239,49387,163,150,361,476,1507,1624,98626,722,326,3131
30,31,30031,Montana,Gallatin County,56310,52111,277,266,900,913,2377,2181,108421,1800,554,4558
30,33,30033,Montana,Garfield County,616,620,4,1,0,1,3,6,1236,0,8,9
30,35,30035,Montana,Glacier County,2142,2192,31,16,25,24,224,267,4334,50,62,491
30,37,30037,Montana,Golden Valley County,387,373,4,3,4,1,23,17,760,8,8,40
30,39,30039,Montana,Granite County,1669,1579,8,10,10,5,49,33,3248,20,16,82
30,41,30041,Montana,Hill County,5946,5679,63,32,36,49,324,338,11625,72,126,662
30,43,30043,Montana,Jefferson County,5938,5645,35,18,18,45,186,173,11583,36,70,359
30,45,30045,Montana,Judith Basin County,999,961,0,2,4,4,16,23,1960,8,0,39
30,47,30047,Montana,Lake County,10098,10357,86,77,77,86,725,734,20455,154,172,1459
30,49,30049,Montana,Lewis and Clark County,32169,32939,181,152,216,290,1162,1221,65108,432,362,2383
30,51,30051,Montana,Liberty County,1099,1153,6,6,2,2,13,6,2252,4,12,19
30,53,30053,Montana,Lincoln County,9587,9362,49,40,16,66,298,370,18949,32,98,668
30,55,30055,Montana,McCone County,822,765,7,5,1,5,14,16,1587,2,14,30
30,57,30057,Montana,Madison County,4393,3895,17,18,21,28,253,122,8288,42,34,375
30,59,30059,Montana,Meagher County,925,878,5,5,0,8,20,14,1803,0,10,34
30,61,30061,Montana,Mineral County,2124,2011,12,12,9,20,72,66,4135,18,24,138
30,63,30063,Montana,Missoula County,55033,54686,406,197,847,1364,2026,2068,109719,1694,812,4094
30,65,30065,Montana,Musselshell County,2177,2115,18,18,28,54,90,82,4292,56,36,172
30,67,30067,Montana,Park County,8039,7855,34,33,21,52,280,269,15894,42,68,549
30,69,30069,Montana,Petroleum County,260,210,0,0,0,0,4,7,470,0,0,11
30,71,30071,Montana,Phillips County,1705,1671,7,3,5,6,75,74,3376,10,14,149
30,73,30073,Montana,Pondera County,2347,2478,15,6,5,37,63,66,4825,10,30,129
30,75,30075,Montana,Powder River County,801,794,1,1,1,1,23,16,1595,2,2,39
30,77,30077,Montana,Powell County,3867,2402,72,14,13,18,136,64,6269,26,144,200
30,79,30079,Montana,Prairie County,514,495,4,0,2,7,27,24,1009,4,8,51
30,81,30081,Montana,Ravalli County,20778,21138,94,81,109,180,793,815,41916,218,188,1608
30,83,30083,Montana,Richland County,5241,4845,30,28,24,31,328,270,10086,48,60,598
30,85,30085,Montana,Roosevelt County,1964,1850,32,17,27,34,286,170,3814,54,64,456
30,87,30087,Montana,Rosebud County,2551,2433,19,20,21,70,274,207,4984,42,38,481
30,89,30089,Montana,Sanders County,5708,5469,24,15,22,35,210,194,11177,44,48,404
30,91,30091,Montana,Sheridan County,1596,1481,17,3,7,9,55,83,3077,14,34,138
30,93,30093,Montana,Silver Bow County,16392,16336,148,96,115,141,822,807,32728,230,296,1629
30,95,30095,Montana,Stillwater County,4705,4537,18,11,28,26,230,182,9242,56,36,412
30,97,30097,Montana,Sweet Grass County,1820,1739,8,7,9,15,53,56,3559,18,16,109
30,99,30099,Montana,Teton County,2849,2958,11,8,23,32,50,52,5807,46,22,102
30,101,30101,Montana,Toole County,2359,1889,35,11,18,19,129,80,4248,36,70,209
30,103,30103,Montana,Treasure County,326,325,0,0,3,4,17,12,651,6,0,29
30,105,30105,Montana,Valley County,3239,3156,16,21,25,43,104,105,6395,50,32,209
30,107,30107,Montana,Wheatland County,997,975,9,2,4,6,72,28,1972,8,18,100
30,109,30109,Montana,Wibaux County,476,460,2,2,3,3,20,16,936,6,4,36
30,111,30111,Montana,Yellowstone County,71840,74095,740,488,506,732,4764,4645,145935,1012,1480,9409
31,1,31001,Nebraska,Adams County,14727,14975,243,165,193,213,1826,1624,29702,386,486,3450
31,3,31003,Nebraska,Antelope County,3119,3045,12,11,12,20,123,92,6164,24,24,215
31,5,31005,Nebraska,Arthur County,223,227,0,0,0,1,13,7,450,0,0,20
31,7,31007,Nebraska,Banner County,352,375,3,7,1,1,20,23,727,2,6,43
31,9,31009,Nebraska,Blaine County,240,217,0,2,0,0,5,2,457,0,0,7
31,11,31011,Nebraska,Boone County,2526,2564,17,9,7,12,59,55,5090,14,34,114
31,13,31013,Nebraska,Box Butte County,4885,4927,80,36,24,48,707,689,9812,48,160,1396
31,15,31015,Nebraska,Boyd County,926,926,2,0,7,20,28,20,1852,14,4,48
31,17,31017,Nebraska,Brown County,1435,1434,7,7,2,4,49,31,2869,4,14,80
31,19,31019,Nebraska,Buffalo County,23448,23726,390,212,419,343,2403,2231,47174,838,780,4634
31,21,31021,Nebraska,Burt County,3051,3068,23,21,4,24,104,119,6119,8,46,223
31,23,31023,Nebraska,Butler County,3923,3883,38,12,21,19,196,162,7806,42,76,358
31,25,31025,Nebraska,Cass County,12765,12498,124,74,50,84,512,454,25263,100,248,966
31,27,31027,Nebraska,Cedar County,4199,4025,15,13,5,9,105,100,8224,10,30,205
31,29,31029,Nebraska,Chase County,1875,1960,15,13,3,3,294,285,3835,6,30,579
31,31,31031,Nebraska,Cherry County,2585,2482,19,7,19,12,117,69,5067,38,38,186
31,33,31033,Nebraska,Cheyenne County,4258,4248,48,17,40,50,366,335,8506,80,96,701
31,35,31035,Nebraska,Clay County,3051,2942,18,13,7,13,290,266,5993,14,36,556
31,37,31037,Nebraska,Colfax County,4888,4495,463,163,91,46,2648,2247,9383,182,926,4895
31,39,31039,Nebraska,Cuming County,4292,4273,32,15,12,31,478,436,8565,24,64,914
31,41,31041,Nebraska,Custer County,5241,5251,42,20,7,21,182,194,10492,14,84,376
31,43,31043,Nebraska,Dakota County,8312,8169,739,611,419,340,4124,3746,16481,838,1478,7870
31,45,31045,Nebraska,Dawes County,3769,3915,110,47,86,80,236,258,7684,172,220,494
31,47,31047,Nebraska,Dawson County,10556,10220,1128,581,154,128,4228,3756,20776,308,2256,7984
31,49,31049,Nebraska,Deuel County,866,864,0,3,3,4,79,60,1730,6,0,139
31,51,31051,Nebraska,Dixon County,2760,2666,23,23,7,13,439,390,5426,14,46,829
31,53,31053,Nebraska,Dodge County,17061,17382,286,183,126,142,2863,2287,34443,252,572,5150
31,55,31055,Nebraska,Douglas County,225998,231243,31410,34095,12511,12318,37977,35967,457241,25022,62820,73944
31,57,31057,Nebraska,Dundy County,806,812,6,3,0,3,63,62,1618,0,12,125
31,59,31059,Nebraska,Fillmore County,2654,2619,18,34,17,22,109,103,5273,34,36,212
31,61,31061,Nebraska,Franklin County,1436,1463,7,5,1,6,27,45,2899,2,14,72
31,63,31063,Nebraska,Frontier County,1291,1265,9,4,1,4,39,44,2556,2,18,83
31,65,31065,Nebraska,Furnas County,2243,2293,16,9,9,11,126,102,4536,18,32,228
31,67,31067,Nebraska,Gage County,10339,10387,108,74,67,82,343,276,20726,134,216,619
31,69,31069,Nebraska,Garden County,928,848,6,0,0,0,60,41,1776,0,12,101
31,71,31071,Nebraska,Garfield County,974,976,5,1,0,2,15,20,1950,0,10,35
31,73,31073,Nebraska,Gosper County,978,945,6,10,5,3,54,64,1923,10,12,118
31,75,31075,Nebraska,Grant County,322,289,1,2,0,1,6,3,611,0,2,9
31,77,31077,Nebraska,Greeley County,1147,1172,8,8,0,2,34,20,2319,0,16,54
31,79,31079,Nebraska,Hall County,27878,27752,1354,975,453,412,9475,8336,55630,906,2708,17811
31,81,31081,Nebraska,Hamilton County,4594,4511,29,15,12,22,193,173,9105,24,58,366
31,83,31083,Nebraska,Harlan County,1711,1602,7,1,3,5,34,42,3313,6,14,76
31,85,31085,Nebraska,Hayes County,457,441,2,2,1,3,27,23,898,2,4,50
31,87,31087,Nebraska,Hitchcock County,1348,1353,6,1,1,4,31,63,2701,2,12,94
31,89,31089,Nebraska,Holt County,4896,4889,22,23,24,29,292,261,9785,48,44,553
31,91,31091,Nebraska,Hooker County,319,346,0,0,2,0,7,13,665,4,0,20
31,93,31093,Nebraska,Howard County,3209,3064,21,14,12,20,67,84,6273,24,42,151
31,95,31095,Nebraska,Jefferson County,3342,3500,21,21,14,13,143,207,6842,28,42,350
31,97,31097,Nebraska,Johnson County,2539,1994,325,8,32,40,338,183,4533,64,650,521
31,99,31099,Nebraska,Kearney County,3147,3173,16,7,9,14,209,215,6320,18,32,424
31,101,31101,Nebraska,Keith County,3875,3818,59,31,28,26,305,320,7693,56,118,625
31,103,31103,Nebraska,Keya Paha County,387,403,0,0,4,0,7,1,790,8,0,8
31,105,31105,Nebraska,Kimball County,1692,1701,9,5,9,26,194,144,3393,18,18,338
31,107,31107,Nebraska,Knox County,3588,3636,18,15,9,20,167,112,7224,18,36,279
31,109,31109,Nebraska,Lancaster County,138473,138633,7869,5824,7519,7784,12266,11301,277106,15038,15738,23567
31,111,31111,Nebraska,Lincoln County,16425,16770,270,192,129,174,1629,1555,33195,258,540,3184
31,113,31113,Nebraska,Logan County,383,344,1,0,2,1,12,16,727,4,2,28
31,115,31115,Nebraska,Loup County,332,324,3,2,1,0,14,12,656,2,6,26
31,117,31117,Nebraska,McPherson County,241,245,2,0,0,0,3,4,486,0,4,7
31,119,31119,Nebraska,Madison County,16133,16374,365,237,294,354,2935,2595,32507,588,730,5530
31,121,31121,Nebraska,Merrick County,3758,3719,24,14,27,47,224,166,7477,54,48,390
31,123,31123,Nebraska,Morrill County,2261,2176,13,7,16,21,371,335,4437,32,26,706
31,125,31125,Nebraska,Nance County,1701,1721,15,4,1,3,51,57,3422,2,30,108
31,127,31127,Nebraska,Nemaha County,3345,3331,60,38,18,32,95,102,6676,36,120,197
31,129,31129,Nebraska,Nuckolls County,1980,2018,5,8,32,24,70,56,3998,64,10,126
31,131,31131,Nebraska,Otoe County,7616,7718,99,62,50,66,741,630,15334,100,198,1371
31,133,31133,Nebraska,Pawnee County,1254,1285,8,7,1,5,26,24,2539,2,16,50
31,135,31135,Nebraska,Perkins County,1447,1375,11,11,0,6,68,58,2822,0,22,126
31,137,31137,Nebraska,Phelps County,4401,4359,16,19,13,29,270,257,8760,26,32,527
31,139,31139,Nebraska,Pierce County,3521,3449,28,14,10,15,81,81,6970,20,56,162
31,141,31141,Nebraska,Platte County,16096,15675,254,180,206,168,3615,3206,31771,412,508,6821
31,143,31143,Nebraska,Polk County,2532,2542,8,11,4,8,177,145,5074,8,16,322
31,145,31145,Nebraska,Red Willow County,5113,5186,89,46,24,24,320,283,10299,48,178,603
31,147,31147,Nebraska,Richardson County,3664,3649,27,10,15,20,84,62,7313,30,54,146
31,149,31149,Nebraska,Rock County,661,666,2,2,2,3,10,16,1327,4,4,26
31,151,31151,Nebraska,Saline County,6677,6308,146,110,221,216,2016,1761,12985,442,292,3777
31,153,31153,Nebraska,Sarpy County,83281,83003,4512,3697,2197,2773,9841,9020,166284,4394,9024,18861
31,155,31155,Nebraska,Saunders County,10621,10301,76,49,44,52,281,237,20922,88,152,518
31,157,31157,Nebraska,Scotts Bluff County,16024,16980,280,165,135,177,4323,4282,33004,270,560,8605
31,159,31159,Nebraska,Seward County,8539,8181,90,41,38,52,266,186,16720,76,180,452
31,161,31161,Nebraska,Sheridan County,2170,2236,10,10,10,13,168,150,4406,20,20,318
31,163,31163,Nebraska,Sherman County,1450,1498,6,4,4,9,34,33,2948,8,12,67
31,165,31165,Nebraska,Sioux County,576,540,3,1,2,1,31,31,1116,4,6,62
31,167,31167,Nebraska,Stanton County,2896,2816,30,27,12,13,198,137,5712,24,60,335
31,169,31169,Nebraska,Thayer County,2423,2443,7,14,9,7,87,69,4866,18,14,156
31,171,31171,Nebraska,Thomas County,343,347,4,5,1,1,17,11,690,2,8,28
31,173,31173,Nebraska,Thurston County,1358,1336,22,14,28,20,241,209,2694,56,44,450
31,175,31175,Nebraska,Valley County,2030,2035,7,10,6,11,93,50,4065,12,14,143
31,177,31177,Nebraska,Washington County,10046,10031,94,76,51,41,340,277,20077,102,188,617
31,179,31179,Nebraska,Wayne County,4473,4460,106,58,23,37,307,308,8933,46,212,615
31,181,31181,Nebraska,Webster County,1675,1676,10,8,6,9,93,97,3351,12,20,190
31,183,31183,Nebraska,Wheeler County,389,376,0,0,0,3,7,5,765,0,0,12
31,185,31185,Nebraska,York County,6410,6602,96,124,38,67,334,384,13012,76,192,718
32,1,32001,Nevada,Churchill County,10656,10283,378,256,317,430,1859,1747,20939,634,756,3606
32,3,32003,Nevada,Clark County,800797,775210,144257,151691,105857,128896,361496,355782,1576007,211714,288514,717278
32,5,32005,Nevada,Douglas County,22573,22219,252,226,377,538,3336,3111,44792,754,504,6447
32,7,32007,Nevada,Elko County,24218,22282,454,242,291,362,6909,6109,46500,582,908,13018
32,9,32009,Nevada,Esmeralda County,399,342,22,8,5,0,91,77,741,10,44,168
32,11,32011,Nevada,Eureka County,994,869,16,9,10,11,155,113,1863,20,32,268
32,13,32013,Nevada,Humboldt County,7851,7253,123,58,75,78,2398,2238,15104,150,246,4636
32,15,32015,Nevada,Lander County,2541,2388,30,23,19,45,676,605,4929,38,60,1281
32,17,32017,Nevada,Lincoln County,2481,2250,142,29,17,21,229,176,4731,34,284,405
32,19,32019,Nevada,Lyon County,26346,25061,485,341,379,537,5621,4776,51407,758,970,10397
32,21,32021,Nevada,Mineral County,1545,1544,116,98,69,86,315,279,3089,138,232,594
32,23,32023,Nevada,Nye County,21040,20150,1056,668,284,589,3695,3436,41190,568,2112,7131
32,27,32027,Nevada,Pershing County,3719,2041,285,24,62,33,1088,580,5760,124,570,1668
32,29,32029,Nevada,Storey County,1935,1814,43,28,37,61,167,163,3749,74,86,330
32,31,32031,Nevada,Washoe County,202249,196729,7205,5931,12521,14622,60111,57773,398978,25042,14410,117884
32,33,32033,Nevada,White Pine County,4672,3526,441,49,59,50,993,607,8198,118,882,1600
32,510,32510,Nevada,Carson City,25187,24388,961,356,709,719,7245,6644,49575,1418,1922,13889
33,1,33001,New Hampshire,Belknap County,29140,29890,269,147,272,435,571,525,59030,544,538,1096
33,3,33003,New Hampshire,Carroll County,23432,23979,168,152,162,212,377,425,47411,324,336,802
33,5,33005,New Hampshire,Cheshire County,35487,37135,399,251,643,650,767,738,72622,1286,798,1505
33,7,33007,New Hampshire,Coos County,15965,14467,210,71,75,125,354,246,30432,150,420,600
33,9,33009,New Hampshire,Grafton County,41118,42037,574,582,1652,1834,1173,1106,83155,3304,1148,2279
33,11,33011,New Hampshire,Hillsborough County,185687,189227,7281,5950,9239,9346,15684,14685,374914,18478,14562,30369
33,13,33013,New Hampshire,Merrimack County,70176,72172,1430,1222,1595,1797,1782,1677,142348,3190,2860,3459
33,15,33015,New Hampshire,Rockingham County,145501,148448,1993,1442,3100,3815,5375,4742,293949,6200,3986,10117
33,17,33017,New Hampshire,Strafford County,58881,61934,1178,692,2510,2385,1903,1719,120815,5020,2356,3622
33,19,33019,New Hampshire,Sullivan County,20479,20942,234,126,185,268,377,363,41421,370,468,740
34,1,34001,New Jersey,Atlantic County,91696,96287,21108,24073,10195,11087,25542,25587,187983,20390,42216,51129
34,3,34003,New Jersey,Bergen County,331931,347371,32626,35905,75092,82928,96215,99782,679302,150184,65252,195997
34,5,34005,New Jersey,Burlington County,159977,164509,40261,41254,11523,12595,19847,18159,324486,23046,80522,38006
34,7,34007,New Jersey,Camden County,170452,179085,51207,58335,14466,15925,43918,45128,349537,28932,102414,89046
34,9,34009,New Jersey,Cape May County,40912,43535,2393,2060,411,532,3863,3589,84447,822,4786,7452
34,11,34011,New Jersey,Cumberland County,53321,53949,18119,14695,1046,1112,24755,22814,107270,2092,36238,47569
34,13,34013,New Jersey,Essex County,193658,196859,155566,179195,22356,24700,95745,94268,390517,44712,311132,190013
34,15,34015,New Jersey,Gloucester County,118284,123848,15547,17255,4239,4722,9809,9691,242132,8478,31094,19500
34,17,34017,New Jersey,Hudson County,218089,217106,47789,51604,55191,55337,141295,145686,435195,110382,95578,286981
34,19,34019,New Jersey,Hunterdon County,55726,57427,1775,1603,2681,2827,4369,4325,113153,5362,3550,8694
34,21,34021,New Jersey,Mercer County,114758,117669,37281,41667,21464,22293,35418,32406,232427,42928,74562,67824
34,23,34023,New Jersey,Middlesex County,243658,252200,47868,50731,103166,102422,90641,91467,495858,206332,95736,182108
34,25,34025,New Jersey,Monmouth County,256128,268323,21672,24551,16575,18039,34813,34117,524451,33150,43344,68930
34,27,34027,New Jersey,Morris County,201053,207487,9277,9548,25986,27255,34520,33627,408540,51972,18554,68147
34,29,34029,New Jersey,Ocean County,272030,291098,10639,11212,5405,6433,29403,28415,563128,10810,21278,57818
34,31,34031,New Jersey,Passaic County,184876,190998,35169,39658,13756,14903,106619,108710,375874,27512,70338,215329
34,33,34033,New Jersey,Salem County,24854,25718,4408,4830,294,368,3247,2841,50572,588,8816,6088
34,35,34035,New Jersey,Somerset County,109958,114125,16788,17872,30006,31781,25531,24530,224083,60012,33576,50061
34,37,34037,New Jersey,Sussex County,65007,66014,2003,1730,1318,1545,6427,6477,131021,2636,4006,12904
34,39,34039,New Jersey,Union County,186438,188510,61786,70377,15082,16711,92122,90430,374948,30164,123572,182552
34,41,34041,New Jersey,Warren County,45909,47971,3005,3015,1492,1551,5406,5290,93880,2984,6010,10696
35,1,35001,New Mexico,Bernalillo County,279438,290455,12896,11237,8870,10865,167035,174592,569893,17740,25792,341627
35,3,35003,New Mexico,Catron County,1730,1513,18,10,3,6,387,283,3243,6,36,670
35,5,35005,New Mexico,Chaves County,29440,29917,798,775,339,432,18658,18718,59357,678,1596,37376
35,6,35006,New Mexico,Cibola County,7488,6303,209,180,68,87,5732,4529,13791,136,418,10261
35,7,35007,New Mexico,Colfax County,5586,5527,65,48,53,41,3040,2836,11113,106,130,5876
35,9,35009,New Mexico,Curry County,21693,20214,1845,1557,423,470,10904,10351,41907,846,3690,21255
35,11,35011,New Mexico,De Baca County,794,816,9,7,2,6,398,405,1610,4,18,803
35,13,35013,New Mexico,Doña Ana County,97886,102482,2922,2350,1366,1515,72665,77368,200368,2732,5844,150033
35,15,35015,New Mexico,Eddy County,27261,26943,723,453,240,280,14825,14723,54204,480,1446,29548
35,17,35017,New Mexico,Grant County,12316,12736,226,144,95,140,6625,6983,25052,190,452,13608
35,19,35019,New Mexico,Guadalupe County,2179,1707,88,17,25,32,1892,1490,3886,50,176,3382
35,21,35021,New Mexico,Harding County,302,291,2,2,0,2,155,138,593,0,4,293
35,23,35023,New Mexico,Hidalgo County,1962,2006,40,37,15,9,1221,1213,3968,30,80,2434
35,25,35025,New Mexico,Lea County,33173,31721,1703,1352,228,243,22230,20475,64894,456,3406,42705
35,27,35027,New Mexico,Lincoln County,8768,9219,112,99,61,64,3327,3400,17987,122,224,6727
35,28,35028,New Mexico,Los Alamos County,8696,8330,157,111,655,624,1762,1812,17026,1310,314,3574
35,29,35029,New Mexico,Luna County,11097,10857,221,229,117,141,8107,7989,21954,234,442,16096
35,31,35031,New Mexico,McKinley County,5792,5811,254,211,337,444,5215,4933,11603,674,508,10148
35,33,35033,New Mexico,Mora County,2156,2058,28,23,13,13,1896,1776,4214,26,56,3672
35,35,35035,New Mexico,Otero County,28960,26843,1637,1172,433,624,13191,12843,55803,866,3274,26034
35,37,35037,New Mexico,Quay County,3641,3863,99,87,49,49,1859,1938,7504,98,198,3797
35,39,35039,New Mexico,Rio Arriba County,14601,15224,174,166,140,187,13621,14047,29825,280,348,27668
35,41,35041,New Mexico,Roosevelt County,8285,8504,324,206,131,149,3982,4018,16789,262,648,8000
35,43,35043,New Mexico,Sandoval County,56486,58311,2153,1856,983,1465,28940,29673,114797,1966,4306,58613
35,45,35045,New Mexico,San Juan County,33128,33901,564,411,331,395,12904,12630,67029,662,1128,25534
35,47,35047,New Mexico,San Miguel County,12280,12522,303,267,190,215,10549,10613,24802,380,606,21162
35,49,35049,New Mexico,Santa Fe County,65820,70448,1019,781,985,1347,37748,38781,136268,1970,2038,76529
35,51,35051,New Mexico,Sierra County,4980,4924,54,34,38,70,1677,1665,9904,76,108,3342
35,53,35053,New Mexico,Socorro County,6649,6455,142,95,128,258,4148,4135,13104,256,284,8283
35,55,35055,New Mexico,Taos County,14073,14676,153,130,129,202,9297,9204,28749,258,306,18501
35,57,35057,New Mexico,Torrance County,7249,6641,237,110,35,51,3653,3117,13890,70,474,6770
35,59,35059,New Mexico,Union County,2040,1652,84,8,19,11,1058,690,3692,38,168,1748
35,61,35061,New Mexico,Valencia County,33956,33881,798,550,260,352,23570,23303,67837,520,1596,46873
36,1,36001,New York,Albany County,112279,119259,20431,22665,10189,10696,9293,9809,231538,20378,40862,19102
36,3,36003,New York,Allegany County,22325,21723,403,261,266,311,417,367,44048,532,806,784
36,5,36005,New York,Bronx County,302291,331989,288327,330229,31392,33294,376695,422885,634280,62784,576654,799580
36,7,36007,New York,Broome County,80355,83118,6024,6092,4203,4221,4299,4177,163473,8406,12048,8476
36,9,36009,New York,Cattaraugus County,34730,35189,682,441,308,337,829,806,69919,616,1364,1635
36,11,36011,New York,Cayuga County,35365,35158,2576,824,208,314,1484,917,70523,416,5152,2401
36,13,36013,New York,Chautauqua County,58203,60516,2076,1469,394,479,5089,4775,118719,788,4152,9864
36,15,36015,New York,Chemung County,35777,37910,3383,2016,607,640,1520,1180,73687,1214,6766,2700
36,17,36017,New York,Chenango County,22739,22787,287,197,137,142,587,500,45526,274,574,1087
36,19,36019,New York,Clinton County,37227,36962,2857,700,466,690,1539,863,74189,932,5714,2402
36,21,36021,New York,Columbia County,26575,26944,1804,1357,545,661,1606,1383,53519,1090,3608,2989
36,23,36023,New York,Cortland County,21980,22978,553,440,192,312,681,673,44958,384,1106,1354
36,25,36025,New York,Delaware County,21116,20789,600,359,213,260,899,862,41905,426,1200,1761
36,27,36027,New York,Dutchess County,117696,120638,18604,16852,5189,5734,19668,18292,238334,10378,37208,37960
36,29,36029,New York,Erie County,355022,373538,59438,68890,17228,18001,25786,27183,728560,34456,118876,52969
36,31,36031,New York,Essex County,17610,17239,910,111,129,160,822,290,34849,258,1820,1112
36,33,36033,New York,Franklin County,22098,19955,3090,125,124,117,1407,404,42053,248,6180,1811
36,35,36035,New York,Fulton County,25045,25724,774,424,161,221,977,884,50769,322,1548,1861
36,37,36037,New York,Genesee County,26339,26865,1095,730,186,195,1111,878,53204,372,2190,1989
36,39,36039,New York,Greene County,21347,21030,2235,655,331,291,1775,1179,42377,662,4470,2954
36,41,36041,New York,Hamilton County,2126,2122,31,16,12,22,39,48,4248,24,62,87
36,43,36043,New York,Herkimer County,29166,29713,519,412,158,201,783,631,58879,316,1038,1414
36,45,36045,New York,Jefferson County,49607,46489,4744,2721,982,909,5008,3553,96096,1964,9488,8561
36,47,36047,New York,Kings County,625435,648886,384269,480571,156021,168168,234426,249253,1274321,312042,768538,483679
36,49,36049,New York,Lewis County,12955,12628,108,81,49,56,294,169,25583,98,216,463
36,51,36051,New York,Livingston County,29140,29687,1405,454,364,496,1427,1024,58827,728,2810,2451
36,53,36053,New York,Madison County,33108,34010,761,675,307,386,849,805,67118,614,1522,1654
36,55,36055,New York,Monroe County,277079,292855,55858,64643,13085,14274,33150,34938,569934,26170,111716,68088
36,57,36057,New York,Montgomery County,22498,23253,863,738,201,254,3729,3675,45751,402,1726,7404
36,59,36059,New York,Nassau County,488629,507192,83490,93939,71693,75908,120248,116977,995821,143386,166980,237225
36,61,36061,New York,New York County,508161,543563,134515,155208,92344,116883,198635,218124,1051724,184688,269030,416759
36,63,36063,New York,Niagara County,89528,93679,7518,8031,1087,1291,3484,3486,183207,2174,15036,6970
36,65,36065,New York,Oneida County,96769,99798,9324,6967,4545,4943,7396,6687,196567,9090,18648,14083
36,67,36067,New York,Onondaga County,178038,190212,26199,29115,8487,9261,11795,12007,368250,16974,52398,23802
36,69,36069,New York,Ontario County,50054,52584,1575,1452,701,834,2973,2641,102638,1402,3150,5614
36,71,36071,New York,Orange County,153929,153349,25733,25081,5566,5856,41765,41237,307278,11132,51466,83002
36,73,36073,New York,Orleans County,17991,18386,1390,1177,121,120,1081,985,36377,242,2780,2066
36,75,36075,New York,Oswego County,56301,56075,792,629,321,485,1616,1602,112376,642,1584,3218
36,77,36077,New York,Otsego County,27040,28895,790,715,372,498,1139,1147,55935,744,1580,2286
36,79,36079,New York,Putnam County,44756,45015,2038,1839,986,1248,8358,7768,89771,1972,4076,16126
36,81,36081,New York,Queens County,536251,541904,214048,252167,292194,314163,318271,316663,1078155,584388,428096,634934
36,83,36083,New York,Rensselaer County,67433,69379,6223,6573,2346,2079,4017,4243,136812,4692,12446,8260
36,85,36085,New York,Richmond County,173100,181462,25778,29586,25395,26730,43731,44907,354562,50790,51556,88638
36,87,36087,New York,Rockland County,125495,128165,20385,22227,9534,10778,30402,29535,253660,19068,40770,59937
36,89,36089,New York,St. Lawrence County,50733,50264,2204,544,553,625,1616,978,100997,1106,4408,2594
36,91,36091,New York,Saratoga County,105236,108392,2459,2164,3194,3405,4017,3754,213628,6388,4918,7771
36,93,36093,New York,Schenectady County,58567,61771,9715,10078,3769,3969,5851,5689,120338,7538,19430,11540
36,95,36095,New York,Schoharie County,14831,14824,260,226,112,124,538,527,29655,224,520,1065
36,97,36097,New York,Schuyler County,8557,8600,100,97,45,73,165,198,17157,90,200,363
36,99,36099,New York,Seneca County,15741,15356,1564,277,132,157,842,415,31097,264,3128,1257
36,101,36101,New York,Steuben County,44785,45589,1002,612,798,758,862,764,90374,1596,2004,1626
36,103,36103,New York,Suffolk County,613197,630442,62825,67352,30569,31856,153446,144983,1243639,61138,125650,298429
36,105,36105,New York,Sullivan County,32192,31362,4298,3233,716,771,6745,5911,63554,1432,8596,12656
36,107,36107,New York,Tioga County,23006,23470,300,210,178,204,543,462,46476,356,600,1005
36,109,36109,New York,Tompkins County,40403,42525,2281,2241,5457,5167,2697,2822,82928,10914,4562,5519
36,111,36111,New York,Ulster County,76013,79054,7417,5425,1714,2037,9944,8894,155067,3428,14834,18838
36,113,36113,New York,Warren County,29872,31173,554,380,267,346,923,880,61045,534,1108,1803
36,115,36115,New York,Washington County,28980,28636,1937,226,152,202,1233,568,57616,304,3874,1801
36,117,36117,New York,Wayne County,41558,42430,1596,1230,298,346,2324,1896,83988,596,3192,4220
36,119,36119,New York,Westchester County,346942,361084,75163,86340,28801,33739,124076,123094,708026,57602,150326,247170
36,121,36121,New York,Wyoming County,19001,17760,2136,91,98,111,985,336,36761,196,4272,1321
36,123,36123,New York,Yates County,11747,12363,134,93,57,141,313,255,24110,114,268,568
37,1,37001,North Carolina,Alamance County,59757,64939,16211,19158,1411,1547,11240,10890,124696,2822,32422,22130
37,3,37003,North Carolina,Alexander County,17058,16989,1428,786,189,196,943,845,34047,378,2856,1788
37,5,37005,North Carolina,Alleghany County,5257,5373,101,96,43,46,638,459,10630,86,202,1097
37,7,37007,North Carolina,Anson County,5986,5602,5992,5854,199,161,656,350,11588,398,11984,1006
37,9,37009,North Carolina,Ashe County,12875,13477,156,106,69,69,829,561,26352,138,312,1390
37,11,37011,North Carolina,Avery County,8613,7705,692,130,47,60,516,371,16318,94,1384,887
37,13,37013,North Carolina,Beaufort County,16351,17479,5234,6408,112,137,1850,1919,33830,224,10468,3769
37,15,37015,North Carolina,Bertie County,3463,3387,5878,5697,61,84,289,157,6850,122,11756,446
37,17,37017,North Carolina,Bladen County,9739,10154,5002,6133,46,63,1344,1194,19893,92,10004,2538
37,19,37019,North Carolina,Brunswick County,58987,64589,6828,7480,443,627,3619,3423,123576,886,13656,7042
37,21,37021,North Carolina,Buncombe County,111879,121736,7986,8339,1732,1985,9133,8737,233615,3464,15972,17870
37,23,37023,North Carolina,Burke County,38300,39614,3675,2548,1674,1613,3159,2696,77914,3348,7350,5855
37,25,37025,North Carolina,Cabarrus County,77093,79602,19991,22542,5162,5101,12088,11946,156695,10324,39982,24034
37,27,37027,North Carolina,Caldwell County,37164,38033,2082,2156,291,328,2601,2253,75197,582,4164,4854
37,29,37029,North Carolina,Camden County,4494,4489,616,638,114,119,182,145,8983,228,1232,327
37,31,37031,North Carolina,Carteret County,30550,32077,2029,1893,384,493,1647,1420,62627,768,4058,3067
37,33,37033,North Carolina,Caswell County,7371,7215,3740,3555,71,60,600,435,14586,142,7480,1035
37,35,37035,North Carolina,Catawba County,65404,68386,7003,7246,3423,3772,8420,7755,133790,6846,14006,16175
37,37,37037,North Carolina,Chatham County,29363,31830,4347,4907,742,921,4646,4380,61193,1484,8694,9026
37,39,37039,North Carolina,Cherokee County,13035,13741,215,238,91,112,461,476,26776,182,430,937
37,41,37041,North Carolina,Chowan County,4223,4501,2176,2616,55,61,291,231,8724,110,4352,522
37,43,37043,North Carolina,Clay County,5219,5552,80,68,18,32,215,219,10771,36,160,434
37,45,37045,North Carolina,Cleveland County,36136,38122,9384,11031,479,552,1900,1790,74258,958,18768,3690
37,47,37047,North Carolina,Columbus County,17215,17835,8582,8383,140,163,1677,1417,35050,280,17164,3094
37,49,37049,North Carolina,Craven County,37481,35894,10613,11201,1442,1544,4276,3494,73375,2884,21226,7770
37,51,37051,North Carolina,Cumberland County,89173,82206,61790,69459,3908,5196,20944,19628,171379,7816,123580,40572
37,53,37053,North Carolina,Currituck County,12506,12617,823,776,91,140,601,611,25123,182,1646,1212
37,55,37055,North Carolina,Dare County,17013,17714,565,453,110,216,1487,1374,34727,220,1130,2861
37,57,37057,North Carolina,Davidson County,70505,73008,8026,8874,1211,1506,6458,5992,143513,2422,16052,12450
37,59,37059,North Carolina,Davie County,18888,19666,1302,1462,154,212,1610,1497,38554,308,2604,3107
37,61,37061,North Carolina,Duplin County,20616,20737,6857,8105,224,216,7248,6269,41353,448,13714,13517
37,63,37063,North Carolina,Durham County,84866,88887,54225,64344,8588,8997,22957,20971,173753,17176,108450,43928
37,65,37065,North Carolina,Edgecombe County,9800,10648,13306,16445,75,90,1345,1208,20448,150,26612,2553
37,67,37067,North Carolina,Forsyth County,122366,132376,47830,57219,4460,5326,25445,25383,254742,8920,95660,50828
37,69,37069,North Carolina,Franklin County,24550,24311,8616,9451,203,282,3464,2789,48861,406,17232,6253
37,71,37071,North Carolina,Gaston County,84800,89497,18730,21493,1676,1978,8614,8400,174297,3352,37460,17014
37,73,37073,North Carolina,Gates County,3754,3796,1751,1861,21,15,149,127,7550,42,3502,276
37,75,37075,North Carolina,Graham County,3741,3741,27,17,24,22,184,132,7482,48,54,316
37,77,37077,North Carolina,Granville County,19711,19281,9879,9432,193,232,2715,2432,38992,386,19758,5147
37,79,37079,North Carolina,Greene County,6680,5698,4376,3375,50,72,1916,1392,12378,100,8752,3308
37,81,37081,North Carolina,Guilford County,144895,155730,86831,103307,13928,14390,22710,22481,300625,27856,173662,45191
37,83,37083,North Carolina,Halifax County,9756,10201,12753,14131,203,224,831,727,19957,406,25506,1558
37,85,37085,North Carolina,Harnett County,48200,48760,14629,15206,714,1030,9337,8841,96960,1428,29258,18178
37,87,37087,North Carolina,Haywood County,28804,30949,473,389,156,219,1382,1290,59753,312,946,2672
37,89,37089,North Carolina,Henderson County,52118,56533,1999,2013,643,857,6381,5756,108651,1286,3998,12137
37,91,37091,North Carolina,Hertford County,4413,4000,6954,7479,114,66,645,337,8413,228,13908,982
37,93,37093,North Carolina,Hoke County,13712,13369,9594,10000,326,491,3933,3762,27081,652,19188,7695
37,95,37095,North Carolina,Hyde County,1790,1672,771,549,9,24,281,204,3462,18,1542,485
37,97,37097,North Carolina,Iredell County,74051,75494,10622,11807,2420,2580,7441,7162,149545,4840,21244,14603
37,99,37099,North Carolina,Jackson County,18358,19086,572,465,254,226,1536,1210,37444,508,1144,2746
37,101,37101,North Carolina,Johnston County,81271,83695,16977,18680,858,1114,15234,14241,164966,1716,33954,29475
37,103,37103,North Carolina,Jones County,3140,3179,1275,1486,19,33,282,202,6319,38,2550,484
37,105,37105,North Carolina,Lee County,22677,23484,5867,6480,391,462,6167,5938,46161,782,11734,12105
37,107,37107,North Carolina,Lenoir County,15282,15728,10586,12603,178,235,2483,1939,31010,356,21172,4422
37,109,37109,North Carolina,Lincoln County,39054,39573,2481,2483,312,373,3341,3139,78627,624,4962,6480
37,111,37111,North Carolina,McDowell County,20896,21354,1102,814,247,241,1600,1320,42250,494,2204,2920
37,113,37113,North Carolina,Macon County,16476,17629,368,244,187,189,1337,1304,34105,374,736,2641
37,115,37115,North Carolina,Madison County,10279,10618,218,103,27,84,302,230,20897,54,436,532
37,117,37117,North Carolina,Martin County,5997,6409,4262,5191,63,58,512,404,12406,126,8524,916
37,119,37119,North Carolina,Mecklenburg County,313613,323011,166548,199598,35492,34562,76958,75967,636624,70984,333096,152925
37,121,37121,North Carolina,Mitchell County,7104,7261,65,53,36,70,515,408,14365,72,130,923
37,123,37123,North Carolina,Montgomery County,10243,10506,2394,2775,218,222,2206,2025,20749,436,4788,4231
37,125,37125,North Carolina,Moore County,40784,43055,5573,6528,719,876,3735,3421,83839,1438,11146,7156
37,127,37127,North Carolina,Nash County,25239,26340,18067,20844,461,444,3623,3317,51579,922,36134,6940
37,129,37129,North Carolina,New Hanover County,92287,100471,14565,16930,1657,2028,6826,6784,192758,3314,29130,13610
37,131,37131,North Carolina,Northampton County,3915,3949,5405,5744,29,30,282,231,7864,58,10810,513
37,133,37133,North Carolina,Onslow County,83891,66908,16609,14600,2033,2419,14658,10863,150799,4066,33218,25521
37,135,37135,North Carolina,Orange County,54864,59316,8008,9479,5699,6267,6555,6261,114180,11398,16016,12816
37,137,37137,North Carolina,Pamlico County,4945,4936,1319,1092,33,43,288,254,9881,66,2638,542
37,139,37139,North Carolina,Pasquotank County,11563,11722,6933,7644,318,312,1136,1164,23285,636,13866,2300
37,141,37141,North Carolina,Pender County,25651,25729,4578,4715,173,260,2480,2262,51380,346,9156,4742
37,143,37143,North Carolina,Perquimans County,4877,5166,1406,1644,30,39,192,178,10043,60,2812,370
37,145,37145,North Carolina,Person County,13512,14118,4964,5614,87,81,969,816,27630,174,9928,1785
37,147,37147,North Carolina,Pitt County,51369,55453,29004,35850,1829,2013,5951,5779,106822,3658,58008,11730
37,149,37149,North Carolina,Polk County,9167,10060,455,424,77,97,643,580,19227,154,910,1223
37,151,37151,North Carolina,Randolph County,62862,64704,4740,4784,987,1208,9098,8126,127566,1974,9480,17224
37,153,37153,North Carolina,Richmond County,13580,13915,6906,7406,203,237,1691,1361,27495,406,13812,3052
37,155,37155,North Carolina,Robeson County,19519,20427,14711,16102,405,458,6355,5693,39946,810,29422,12048
37,157,37157,North Carolina,Rockingham County,34335,36223,8078,9221,257,355,3076,2684,70558,514,16156,5760
37,159,37159,North Carolina,Rowan County,55917,56884,11595,12379,827,926,7213,6187,112801,1654,23190,13400
37,161,37161,North Carolina,Rutherford County,28133,30181,3192,3416,190,224,1612,1613,58314,380,6384,3225
37,163,37163,North Carolina,Sampson County,21006,21279,8047,8823,183,216,6940,6117,42285,366,16094,13057
37,165,37165,North Carolina,Scotland County,7655,7870,6770,6772,164,157,664,486,15525,328,13540,1150
37,167,37167,North Carolina,Stanly County,26318,26668,3654,3485,655,616,1487,1299,52986,1310,7308,2786
37,169,37169,North Carolina,Stokes County,20871,21858,950,914,86,102,728,779,42729,172,1900,1507
37,171,37171,North Carolina,Surry County,32447,34240,1500,1530,233,332,4105,3858,66687,466,3000,7963
37,173,37173,North Carolina,Swain County,4330,4670,87,81,50,52,428,394,9000,100,174,822
37,175,37175,North Carolina,Transylvania County,15379,16744,672,535,101,123,636,532,32123,202,1344,1168
37,177,37177,North Carolina,Tyrrell County,1177,1100,994,537,38,40,169,207,2277,76,1988,376
37,179,37179,North Carolina,Union County,96264,98309,14461,15591,4118,4552,13851,13664,194573,8236,28922,27515
37,181,37181,North Carolina,Vance County,9634,10442,10402,12550,124,211,1919,1756,20076,248,20804,3675
37,183,37183,North Carolina,Wake County,371942,382409,107856,126000,42404,43016,57898,57633,754351,84808,215712,115531
37,185,37185,North Carolina,Warren County,4045,3943,4966,5166,32,55,422,351,7988,64,9932,773
37,187,37187,North Carolina,Washington County,2659,2863,2607,3061,18,29,368,285,5522,36,5214,653
37,189,37189,North Carolina,Watauga County,26549,26720,586,456,277,371,1294,967,53269,554,1172,2261
37,191,37191,North Carolina,Wayne County,38724,38637,18341,21514,711,937,7903,7424,77361,1422,36682,15327
37,193,37193,North Carolina,Wilkes County,31037,32387,1720,1484,173,221,2468,2260,63424,346,3440,4728
37,195,37195,North Carolina,Wilson County,22156,23529,15118,18003,550,474,4685,4134,45685,1100,30236,8819
37,197,37197,North Carolina,Yadkin County,17470,17912,667,618,77,96,2275,2063,35382,154,1334,4338
37,199,37199,North Carolina,Yancey County,8537,8884,123,82,22,35,548,450,17421,44,246,998
38,1,38001,North Dakota,Adams County,1034,1043,13,8,19,42,24,11,2077,38,26,35
38,3,38003,North Dakota,Barnes County,4922,4894,122,69,51,44,131,99,9816,102,244,230
38,5,38005,North Dakota,Benson County,1503,1336,13,18,12,5,153,125,2839,24,26,278
38,7,38007,North Dakota,Billings County,462,410,1,3,32,6,10,14,872,64,2,24
38,9,38009,North Dakota,Bottineau County,3023,2815,29,20,12,26,71,70,5838,24,58,141
38,11,38011,North Dakota,Bowman County,1469,1432,5,4,2,3,87,78,2901,4,10,165
38,13,38013,North Dakota,Burke County,1060,956,9,7,7,6,26,37,2016,14,18,63
38,15,38015,North Dakota,Burleigh County,42991,43449,1435,849,416,459,1375,1259,86440,832,2870,2634
38,17,38017,North Dakota,Cass County,79377,78327,6015,5573,3134,3002,2730,2405,157704,6268,12030,5135
38,19,38019,North Dakota,Cavalier County,1853,1751,12,4,5,11,29,25,3604,10,24,54
38,21,38021,North Dakota,Dickey County,2343,2318,29,19,8,21,90,78,4661,16,58,168
38,23,38023,North Dakota,Divide County,1094,1020,39,5,17,25,32,33,2114,34,78,65
38,25,38025,North Dakota,Dunn County,1989,1738,41,32,40,22,126,123,3727,80,82,249
38,27,38027,North Dakota,Eddy County,1033,1084,8,4,5,3,58,41,2117,10,16,99
38,29,38029,North Dakota,Emmons County,1587,1536,4,5,7,22,14,23,3123,14,8,37
38,31,38031,North Dakota,Foster County,1565,1537,8,4,6,12,48,26,3102,12,16,74
38,33,38033,North Dakota,Golden Valley County,841,851,7,6,1,2,24,35,1692,2,14,59
38,35,38035,North Dakota,Grand Forks County,30782,29493,1816,1253,1025,1000,1654,1594,60275,2050,3632,3248
38,37,38037,North Dakota,Grant County,1097,1076,2,1,2,4,25,8,2173,4,4,33
38,39,38039,North Dakota,Griggs County,1117,1076,6,4,2,2,15,14,2193,4,12,29
38,41,38041,North Dakota,Hettinger County,1144,1177,7,9,1,8,35,34,2321,2,14,69
38,43,38043,North Dakota,Kidder County,1276,1134,5,7,9,7,68,49,2410,18,10,117
38,45,38045,North Dakota,LaMoure County,2043,1923,10,7,2,1,32,37,3966,4,20,69
38,47,38047,North Dakota,Logan County,929,859,2,5,3,5,13,35,1788,6,4,48
38,49,38049,North Dakota,McHenry County,2887,2696,9,14,7,11,58,56,5583,14,18,114
38,51,38051,North Dakota,McIntosh County,1197,1214,6,14,4,20,38,27,2411,8,12,65
38,53,38053,North Dakota,McKenzie County,6857,5796,196,125,70,77,813,645,12653,140,392,1458
38,55,38055,North Dakota,McLean County,4313,4150,32,13,16,12,131,112,8463,32,64,243
38,57,38057,North Dakota,Mercer County,3981,3728,39,16,9,34,117,130,7709,18,78,247
38,59,38059,North Dakota,Morton County,14645,14262,220,196,65,82,828,464,28907,130,440,1292
38,61,38061,North Dakota,Mountrail County,3840,2962,115,75,16,23,541,402,6802,32,230,943
38,63,38063,North Dakota,Nelson County,1397,1338,18,8,4,3,75,58,2735,8,36,133
38,65,38065,North Dakota,Oliver County,974,890,4,4,1,4,27,13,1864,2,8,40
38,67,38067,North Dakota,Pembina County,3343,3034,29,18,10,17,134,98,6377,20,58,232
38,69,38069,North Dakota,Pierce County,1844,1820,19,17,2,7,45,35,3664,4,38,80
38,71,38071,North Dakota,Ramsey County,4897,4742,118,34,96,40,199,171,9639,192,236,370
38,73,38073,North Dakota,Ransom County,2596,2387,32,12,11,47,76,55,4983,22,64,131
38,75,38075,North Dakota,Renville County,1178,1069,6,3,2,5,37,27,2247,4,12,64
38,77,38077,North Dakota,Richland County,7825,7244,119,63,48,55,297,280,15069,96,238,577
38,79,38079,North Dakota,Rolette County,1339,1268,43,23,14,12,149,144,2607,28,86,293
38,81,38081,North Dakota,Sargent County,1916,1729,59,12,22,14,75,56,3645,44,118,131
38,83,38083,North Dakota,Sheridan County,640,622,2,2,0,4,9,9,1262,0,4,18
38,85,38085,North Dakota,Sioux County,321,254,14,17,4,4,103,113,575,8,28,216
38,87,38087,North Dakota,Slope County,366,349,5,3,0,0,27,4,715,0,10,31
38,89,38089,North Dakota,Stark County,14889,13982,576,361,192,298,997,794,28871,384,1152,1791
38,91,38091,North Dakota,Steele County,945,885,6,5,2,2,17,25,1830,4,12,42
38,93,38093,North Dakota,Stutsman County,9817,9591,247,126,112,69,286,255,19408,224,494,541
38,95,38095,North Dakota,Towner County,1036,997,6,2,2,1,35,24,2033,4,12,59
38,97,38097,North Dakota,Traill County,3882,3738,55,14,10,40,159,139,7620,20,110,298
38,99,38099,North Dakota,Walsh County,5151,4884,37,40,44,50,699,573,10035,88,74,1272
38,101,38101,North Dakota,Ward County,30791,28294,1954,1312,627,618,2241,2058,59085,1254,3908,4299
38,103,38103,North Dakota,Wells County,1865,1865,9,5,5,7,18,27,3730,10,18,45
38,105,38105,North Dakota,Williams County,17312,14952,1215,706,152,201,1864,1520,32264,304,2430,3384
39,1,39001,Ohio,Adams County,13326,13559,82,54,19,82,154,134,26885,38,164,288
39,3,39003,Ohio,Allen County,42788,42412,6706,6115,366,452,1904,1516,85200,732,13412,3420
39,5,39005,Ohio,Ashland County,25384,26353,273,189,139,247,387,419,51737,278,546,806
39,7,39007,Ohio,Ashtabula County,45063,45415,2508,1207,191,283,2338,1980,90478,382,5016,4318
39,9,39009,Ohio,Athens County,29540,30060,923,934,1018,1016,631,634,59600,2036,1846,1265
39,11,39011,Ohio,Auglaize County,22135,22238,194,104,159,129,433,378,44373,318,388,811
39,13,39013,Ohio,Belmont County,31196,31371,2285,558,147,187,450,308,62567,294,4570,758
39,15,39015,Ohio,Brown County,20895,21296,245,188,54,74,273,265,42191,108,490,538
39,17,39017,Ohio,Butler County,157818,163993,17297,17991,7123,7729,9857,9256,321811,14246,34594,19113
39,19,39019,Ohio,Carroll County,13090,13083,120,69,47,63,179,164,26173,94,240,343
39,21,39021,Ohio,Champaign County,18284,18508,471,359,82,118,354,305,36792,164,942,659
39,23,39023,Ohio,Clark County,56363,60112,5929,6092,405,562,2650,2201,116475,810,11858,4851
39,25,39025,Ohio,Clermont County,96563,99546,1910,1682,1407,1430,2209,2064,196109,2814,3820,4273
39,27,39027,Ohio,Clinton County,19555,20170,513,429,98,139,401,312,39725,196,1026,713
39,29,39029,Ohio,Columbiana County,48407,48619,1975,562,169,175,1279,658,97026,338,3950,1937
39,31,39031,Ohio,Coshocton County,17523,17806,222,215,46,86,224,205,35329,92,444,429
39,33,39033,Ohio,Crawford County,19477,20606,285,164,135,111,368,377,40083,270,570,745
39,35,39035,Ohio,Cuyahoga County,381604,402876,171675,205307,20037,21421,38192,39151,784480,40074,343350,77343
39,37,39037,Ohio,Darke County,24710,24997,207,147,113,121,459,404,49707,226,414,863
39,39,39039,Ohio,Defiance County,17975,18316,449,352,88,102,2046,1901,36291,176,898,3947
39,41,39041,Ohio,Delaware County,89254,91053,4324,3846,8011,7924,3064,2796,180307,16022,8648,5860
39,43,39043,Ohio,Erie County,31432,32931,3273,3329,251,319,1815,1553,64363,502,6546,3368
39,45,39045,Ohio,Fairfield County,67825,68875,7110,6727,1409,1623,1896,1845,136700,2818,14220,3741
39,47,39047,Ohio,Fayette County,13120,13722,396,274,144,139,355,295,26842,288,792,650
39,49,39049,Ohio,Franklin County,432548,447005,149306,164001,37024,38361,39418,36705,879553,74048,298612,76123
39,51,39051,Ohio,Fulton County,20230,20572,206,163,83,104,1898,1822,40802,166,412,3720
39,53,39053,Ohio,Gallia County,13773,14408,404,288,102,118,211,218,28181,204,808,429
39,55,39055,Ohio,Geauga County,45112,45636,571,592,265,365,789,748,90748,530,1142,1537
39,57,39057,Ohio,Greene County,71841,73623,5979,6304,2414,2858,2505,2498,145464,4828,11958,5003
39,59,39059,Ohio,Guernsey County,18495,18644,378,229,85,93,230,217,37139,170,756,447
39,61,39061,Ohio,Hamilton County,271388,281295,100209,116918,11823,12004,14951,14123,552683,23646,200418,29074
39,63,39063,Ohio,Hancock County,34949,36037,910,648,791,701,2262,2096,70986,1582,1820,4358
39,65,39065,Ohio,Hardin County,15062,15127,184,135,88,144,310,299,30189,176,368,609
39,67,39067,Ohio,Harrison County,7113,7291,176,138,22,13,96,85,14404,44,352,181
39,69,39069,Ohio,Henry County,12978,13212,126,91,56,90,1071,1027,26190,112,252,2098
39,71,39071,Ohio,Highland County,20346,21021,343,313,76,105,246,306,41367,152,686,552
39,73,39073,Ohio,Hocking County,13601,13801,120,86,43,68,157,165,27402,86,240,322
39,75,39075,Ohio,Holmes County,21662,21672,127,60,24,59,240,212,43334,48,254,452
39,77,39077,Ohio,Huron County,27621,28375,475,358,94,124,2052,1969,55996,188,950,4021
39,79,39079,Ohio,Jackson County,15374,16001,132,101,48,64,200,155,31375,96,264,355
39,81,39081,Ohio,Jefferson County,28979,30755,1764,1807,136,198,493,580,59734,272,3528,1073
39,83,39083,Ohio,Knox County,29469,30763,330,325,161,199,525,453,60232,322,660,978
39,85,39085,Ohio,Lake County,103067,107845,5191,5844,1609,1865,5749,5039,210912,3218,10382,10788
39,87,39087,Ohio,Lawrence County,27609,29177,702,567,115,165,318,276,56786,230,1404,594
39,89,39089,Ohio,Licking County,78680,81878,3815,3595,1902,2133,1793,1881,160558,3804,7630,3674
39,91,39091,Ohio,Logan County,21458,21807,443,391,141,196,508,430,43265,282,886,938
39,93,39093,Ohio,Lorain County,130658,136272,14514,13283,1895,2311,16046,16139,266930,3790,29028,32185
39,95,39095,Ohio,Lucas County,155065,162774,40895,46242,3481,3902,15623,15981,317839,6962,81790,31604
39,97,39097,Ohio,Madison County,21001,19247,2527,359,319,315,589,419,40248,638,5054,1008
39,99,39099,Ohio,Mahoning County,90223,93398,17632,19108,1011,1110,8181,6591,183621,2022,35264,14772
39,101,39101,Ohio,Marion County,30184,28675,3291,922,189,211,1050,803,58859,378,6582,1853
39,103,39103,Ohio,Medina County,85021,86780,1433,1258,1065,1265,2145,1990,171801,2130,2866,4135
39,105,39105,Ohio,Meigs County,10977,11260,140,90,17,32,94,77,22237,34,280,171
39,107,39107,Ohio,Mercer County,20030,19702,134,80,108,124,440,374,39732,216,268,814
39,109,39109,Ohio,Miami County,49147,50811,1426,1185,831,1028,1023,978,99958,1662,2852,2001
39,111,39111,Ohio,Monroe County,6711,6613,51,36,7,20,51,59,13324,14,102,110
39,113,39113,Ohio,Montgomery County,188852,199230,52905,61242,5826,6635,8775,8553,388082,11652,105810,17328
39,115,39115,Ohio,Morgan County,6683,6728,241,212,10,16,80,65,13411,20,482,145
39,117,39117,Ohio,Morrow County,17119,17172,174,96,50,90,297,259,34291,100,348,556
39,119,39119,Ohio,Muskingum County,38520,41001,1784,1531,209,311,521,520,79521,418,3568,1041
39,121,39121,Ohio,Noble County,7954,5816,371,29,14,28,67,34,13770,28,742,101
39,123,39123,Ohio,Ottawa County,19543,19755,223,177,52,93,1071,993,39298,104,446,2064
39,125,39125,Ohio,Paulding County,8913,9071,121,98,23,43,489,420,17984,46,242,909
39,127,39127,Ohio,Perry County,17587,17569,118,77,26,46,139,177,35156,52,236,316
39,129,39129,Ohio,Pickaway County,28001,26716,1971,311,164,152,464,384,54717,328,3942,848
39,131,39131,Ohio,Pike County,13128,13484,198,129,34,40,140,179,26612,68,396,319
39,133,39133,Ohio,Portage County,72360,75182,3685,4099,1682,1672,1492,1694,147542,3364,7370,3186
39,135,39135,Ohio,Preble County,19606,20003,178,132,99,154,188,222,39609,198,356,410
39,137,39137,Ohio,Putnam County,16582,16588,119,92,36,55,1156,1064,33170,72,238,2220
39,139,39139,Ohio,Richland County,52176,53272,7338,4281,424,540,1377,1114,105448,848,14676,2491
39,141,39141,Ohio,Ross County,35327,34239,3282,1031,211,219,595,465,69566,422,6564,1060
39,143,39143,Ohio,Sandusky County,26939,27557,1051,965,123,171,3010,2931,54496,246,2102,5941
39,145,39145,Ohio,Scioto County,34697,36396,1471,574,135,159,553,496,71093,270,2942,1049
39,147,39147,Ohio,Seneca County,25790,26050,840,629,206,217,1590,1395,51840,412,1680,2985
39,149,39149,Ohio,Shelby County,22851,22797,618,514,297,294,399,379,45648,594,1236,778
39,151,39151,Ohio,Stark County,158411,167777,14435,15161,1595,1990,4182,4070,326188,3190,28870,8252
39,153,39153,Ohio,Summit County,206543,216426,37954,43739,10450,10631,6215,6206,422969,20900,75908,12421
39,155,39155,Ohio,Trumbull County,85455,89565,8221,8829,471,639,1924,1907,175020,942,16442,3831
39,157,39157,Ohio,Tuscarawas County,43592,44991,529,423,155,249,1662,1275,88583,310,1058,2937
39,159,39159,Ohio,Union County,25836,27546,442,1142,1445,1431,583,592,53382,2890,884,1175
39,161,39161,Ohio,Van Wert County,13473,13850,198,122,34,58,543,513,27323,68,396,1056
39,163,39163,Ohio,Vinton County,6388,6309,43,39,14,17,59,58,12697,28,86,117
39,165,39165,Ohio,Warren County,102761,103417,5593,3128,7470,7262,3380,3455,206178,14940,11186,6835
39,167,39167,Ohio,Washington County,28160,29304,475,308,199,212,330,366,57464,398,950,696
39,169,39169,Ohio,Wayne County,54607,55570,1023,871,584,676,1314,1068,110177,1168,2046,2382
39,171,39171,Ohio,Williams County,17542,17896,334,146,96,114,955,836,35438,192,668,1791
39,173,39173,Ohio,Wood County,59897,61858,1910,1794,1187,1230,3823,3649,121755,2374,3820,7472
39,175,39175,Ohio,Wyandot County,10527,10688,58,29,85,68,375,357,21215,170,116,732
40,1,40001,Oklahoma,Adair County,4676,4660,75,55,94,94,836,737,9336,188,150,1573
40,3,40003,Oklahoma,Alfalfa County,2861,2125,250,16,14,8,242,99,4986,28,500,341
40,5,40005,Oklahoma,Atoka County,5076,4896,388,146,53,54,290,210,9972,106,776,500
40,7,40007,Oklahoma,Beaver County,2472,2441,43,31,10,11,691,686,4913,20,86,1377
40,9,40009,Oklahoma,Beckham County,10057,9148,764,179,119,111,2080,1136,19205,238,1528,3216
40,11,40011,Oklahoma,Blaine County,3795,3829,176,150,13,21,654,528,7624,26,352,1182
40,13,40013,Oklahoma,Bryan County,17419,18454,548,392,136,155,1573,1445,35873,272,1096,3018
40,15,40015,Oklahoma,Caddo County,9930,8651,630,199,95,48,2302,1532,18581,190,1260,3834
40,17,40017,Oklahoma,Canadian County,60978,62244,3078,2225,2206,2615,7527,6984,123222,4412,6156,14511
40,19,40019,Oklahoma,Carter County,17595,18475,1696,1579,299,347,1913,1774,36070,598,3392,3687
40,21,40021,Oklahoma,Cherokee County,12198,12879,386,300,229,242,1990,1562,25077,458,772,3552
40,23,40023,Oklahoma,Choctaw County,4366,4853,735,821,29,41,374,325,9219,58,1470,699
40,25,40025,Oklahoma,Cimarron County,1025,1000,5,9,3,5,275,223,2025,6,10,498
40,27,40027,Oklahoma,Cleveland County,110600,111887,8378,7131,6703,6781,13373,12876,222487,13406,16756,26249
40,29,40029,Oklahoma,Coal County,1898,1948,29,22,8,8,124,116,3846,16,58,240
40,31,40031,Oklahoma,Comanche County,41476,37857,11273,9558,1418,1944,8594,7724,79333,2836,22546,16318
40,33,40033,Oklahoma,Cotton County,2247,2329,80,54,7,12,255,219,4576,14,160,474
40,35,40035,Oklahoma,Craig County,4632,4574,332,122,41,57,314,245,9206,82,664,559
40,37,40037,Oklahoma,Creek County,27838,28598,883,739,253,265,1707,1585,56436,506,1766,3292
40,39,40039,Oklahoma,Custer County,11932,12187,544,401,192,182,2710,2760,24119,384,1088,5470
40,41,40041,Oklahoma,Delaware County,13859,14546,132,86,263,259,847,825,28405,526,264,1672
40,43,40043,Oklahoma,Dewey County,2098,2158,24,16,32,25,192,179,4256,64,48,371
40,45,40045,Oklahoma,Ellis County,1768,1830,15,13,6,14,146,134,3598,12,30,280
40,47,40047,Oklahoma,Garfield County,25679,25782,1098,858,364,424,4166,3898,51461,728,2196,8064
40,49,40049,Oklahoma,Garvin County,11174,11595,356,301,77,76,1400,1229,22769,154,712,2629
40,51,40051,Oklahoma,Grady County,23970,23935,683,593,127,173,1771,1602,47905,254,1366,3373
40,53,40053,Oklahoma,Grant County,1966,2014,28,39,3,8,134,119,3980,6,56,253
40,55,40055,Oklahoma,Greer County,2624,2126,416,80,12,6,378,305,4750,24,832,683
40,57,40057,Oklahoma,Harmon County,1046,1115,121,105,20,24,374,421,2161,40,242,795
40,59,40059,Oklahoma,Harper County,1765,1723,13,5,2,7,458,376,3488,4,26,834
40,61,40061,Oklahoma,Haskell County,4618,4615,54,57,48,67,347,252,9233,96,108,599
40,63,40063,Oklahoma,Hughes County,4600,4118,658,116,22,23,463,322,8718,44,1316,785
40,65,40065,Oklahoma,Jackson County,10027,10299,1044,882,155,241,3115,3059,20326,310,2088,6174
40,67,40067,Oklahoma,Jefferson County,2540,2610,59,31,16,17,377,299,5150,32,118,676
40,69,40069,Oklahoma,Johnston County,3973,4038,150,143,24,36,321,307,8011,48,300,628
40,71,40071,Oklahoma,Kay County,17178,17551,564,435,119,159,1929,1677,34729,238,1128,3606
40,73,40073,Oklahoma,Kingfisher County,7071,7162,167,111,26,38,1351,1223,14233,52,334,2574
40,75,40075,Oklahoma,Kiowa County,3585,3605,212,177,17,12,519,515,7190,34,424,1034
40,77,40077,Oklahoma,Latimer County,3327,3263,90,45,24,36,219,207,6590,48,180,426
40,79,40079,Oklahoma,Le Flore County,19022,19274,646,374,158,192,1962,1623,38296,316,1292,3585
40,81,40081,Oklahoma,Lincoln County,14667,14807,349,343,52,83,633,620,29474,104,698,1253
40,83,40083,Oklahoma,Logan County,19802,19952,1941,1966,135,182,1586,1647,39754,270,3882,3233
40,85,40085,Oklahoma,Love County,4279,4298,165,125,35,37,892,770,8577,70,330,1662
40,87,40087,Oklahoma,McClain County,17141,17553,229,179,76,141,1773,1583,34694,152,458,3356
40,89,40089,Oklahoma,McCurtain County,10521,10869,1299,1370,183,132,1048,987,21390,366,2598,2035
40,91,40091,Oklahoma,McIntosh County,6671,6939,312,283,43,62,284,292,13610,86,624,576
40,93,40093,Oklahoma,Major County,3443,3581,37,39,15,43,406,365,7024,30,74,771
40,95,40095,Oklahoma,Marshall County,6617,6960,172,176,32,38,1510,1563,13577,64,344,3073
40,97,40097,Oklahoma,Mayes County,13677,13777,179,122,99,85,832,725,27454,198,358,1557
40,99,40099,Oklahoma,Murray County,5386,5350,120,125,31,54,496,485,10736,62,240,981
40,101,40101,Oklahoma,Muskogee County,19757,20943,3681,3697,197,262,2302,2171,40700,394,7362,4473
40,103,40103,Oklahoma,Noble County,4580,4627,118,96,30,41,244,215,9207,60,236,459
40,105,40105,Oklahoma,Nowata County,3431,3418,140,101,8,12,180,150,6849,16,280,330
40,107,40107,Oklahoma,Okfuskee County,4148,3461,567,294,22,24,265,218,7609,44,1134,483
40,109,40109,Oklahoma,Oklahoma County,278447,284363,60102,66196,13302,15662,74059,68852,562810,26604,120204,142911
40,111,40111,Oklahoma,Okmulgee County,12330,12617,1560,1593,82,95,880,817,24947,164,3120,1697
40,113,40113,Oklahoma,Osage County,15607,15211,2640,2716,73,132,902,900,30818,146,5280,1802
40,115,40115,Oklahoma,Ottawa County,10426,11036,228,140,94,116,946,884,21462,188,456,1830
40,117,40117,Oklahoma,Pawnee County,6368,6444,85,62,33,50,276,249,12812,66,170,525
40,119,40119,Oklahoma,Payne County,33235,32548,1891,1284,2111,1714,2106,1836,65783,4222,3782,3942
40,121,40121,Oklahoma,Pittsburg County,15918,15840,992,414,84,122,1282,1038,31758,168,1984,2320
40,123,40123,Oklahoma,Pontotoc County,12685,13561,501,412,156,226,1138,978,26246,312,1002,2116
40,125,40125,Oklahoma,Pottawatomie County,26263,28465,1072,1178,212,312,1968,1933,54728,424,2144,3901
40,127,40127,Oklahoma,Pushmataha County,3963,4123,59,71,19,19,266,210,8086,38,118,476
40,129,40129,Oklahoma,Roger Mills County,1604,1585,14,12,10,12,127,139,3189,20,28,266
40,131,40131,Oklahoma,Rogers County,34589,34818,671,527,641,753,2341,2315,69407,1282,1342,4656
40,133,40133,Oklahoma,Seminole County,7958,8341,556,485,44,55,665,627,16299,88,1112,1292
40,135,40135,Oklahoma,Sequoyah County,13202,13750,434,334,160,168,954,820,26952,320,868,1774
40,137,40137,Oklahoma,Stephens County,18028,19165,455,431,137,174,1763,1776,37193,274,910,3539
40,139,40139,Oklahoma,Texas County,9110,8328,706,292,360,324,5078,4311,17438,720,1412,9389
40,141,40141,Oklahoma,Tillman County,2968,2952,327,263,18,18,984,1050,5920,36,654,2034
40,143,40143,Oklahoma,Tulsa County,231362,240259,33184,36913,11448,11908,44854,41732,471621,22896,66368,86586
40,145,40145,Oklahoma,Wagoner County,30692,31344,1607,1511,663,759,2826,2640,62036,1326,3214,5466
40,147,40147,Oklahoma,Washington County,19382,20412,727,649,592,611,1701,1541,39794,1184,1454,3242
40,149,40149,Oklahoma,Washita County,4888,4997,90,67,18,45,574,522,9885,36,180,1096
40,151,40151,Oklahoma,Woods County,4072,3736,262,44,65,50,360,302,7808,130,524,662
40,153,40153,Oklahoma,Woodward County,9476,8876,360,58,75,102,1527,1188,18352,150,720,2715
41,1,41001,Oregon,Baker County,7722,7386,75,36,54,96,385,376,15108,108,150,761
41,3,41003,Oregon,Benton County,40175,40342,668,471,3361,3175,3594,3658,80517,6722,1336,7252
41,5,41005,Oregon,Clackamas County,183599,188069,2789,2207,9288,11035,19335,18344,371668,18576,5578,37679
41,7,41007,Oregon,Clatsop County,18387,18848,192,157,295,360,1741,1735,37235,590,384,3476
41,9,41009,Oregon,Columbia County,24309,24079,229,169,212,384,1522,1394,48388,424,458,2916
41,11,41011,Oregon,Coos County,28873,29450,244,156,326,496,2151,2241,58323,652,488,4392
41,13,41013,Oregon,Crook County,11521,11594,63,49,66,104,975,891,23115,132,126,1866
41,15,41015,Oregon,Curry County,10339,10714,67,58,77,117,919,788,21053,154,134,1707
41,17,41017,Oregon,Deschutes County,92126,93909,650,472,1023,1502,8147,8177,186035,2046,1300,16324
41,19,41019,Oregon,Douglas County,50738,52008,316,284,443,783,3288,3444,102746,886,632,6732
41,21,41021,Oregon,Gilliam County,897,891,4,1,9,9,75,66,1788,18,8,141
41,23,41023,Oregon,Grant County,3415,3374,12,8,21,29,138,145,6789,42,24,283
41,25,41025,Oregon,Harney County,3405,3295,47,30,17,27,202,177,6700,34,94,379
41,27,41027,Oregon,Hood River County,10929,10890,110,76,185,228,3920,3528,21819,370,220,7448
41,29,41029,Oregon,Jackson County,99019,103904,1310,848,1449,2052,15438,14290,202923,2898,2620,29728
41,31,41031,Oregon,Jefferson County,9679,9031,171,131,81,135,2609,2305,18710,162,342,4914
41,33,41033,Oregon,Josephine County,39543,41711,318,218,389,548,3430,3290,81254,778,636,6720
41,35,41035,Oregon,Klamath County,30189,30158,349,286,362,420,4948,4448,60347,724,698,9396
41,37,41037,Oregon,Lake County,3799,3378,44,14,37,63,340,338,7177,74,88,678
41,39,41039,Oregon,Lane County,167069,173128,2801,2025,5324,6777,18285,17338,340197,10648,5602,35623
41,41,41041,Oregon,Lincoln County,21639,23128,265,202,264,417,2426,2309,44767,528,530,4735
41,43,41043,Oregon,Linn County,59430,60544,617,422,648,981,6502,5853,119974,1296,1234,12355
41,45,41045,Oregon,Malheur County,15197,12912,389,124,244,218,5615,4976,28109,488,778,10591
41,47,41047,Oregon,Marion County,153340,154936,3198,2289,3973,4651,48971,45735,308276,7946,6396,94706
41,49,41049,Oregon,Morrow County,5459,5320,86,44,26,43,2273,2106,10779,52,172,4379
41,51,41051,Oregon,Multnomah County,319143,323376,24749,24114,30321,35351,50763,46904,642519,60642,49498,97667
41,53,41053,Oregon,Polk County,37738,39613,549,417,823,961,6473,5999,77351,1646,1098,12472
41,55,41055,Oregon,Sherman County,864,799,2,6,4,11,67,56,1663,8,4,123
41,57,41057,Oregon,Tillamook County,12701,12538,132,68,122,155,1478,1356,25239,244,264,2834
41,59,41059,Oregon,Umatilla County,36761,33687,685,273,440,456,11534,9978,70448,880,1370,21512
41,61,41061,Oregon,Union County,12266,12571,135,87,150,189,711,677,24837,300,270,1388
41,63,41063,Oregon,Wallowa County,3386,3504,18,15,11,25,133,124,6890,22,36,257
41,65,41065,Oregon,Wasco County,12145,12126,122,93,110,190,2674,2452,24271,220,244,5126
41,67,41067,Oregon,Washington County,237276,241773,8272,6922,33944,36473,52521,50309,479049,67888,16544,102830
41,69,41069,Oregon,Wheeler County,597,627,1,2,8,6,49,29,1224,16,2,78
41,71,41071,Oregon,Yamhill County,48711,49137,852,435,977,1188,9305,8074,97848,1954,1704,17379
42,1,42001,Pennsylvania,Adams County,48141,49831,1141,944,369,512,3976,3535,97972,738,2282,7511
42,3,42003,Pennsylvania,Allegheny County,472206,498963,75609,87785,25934,25180,13947,13605,971169,51868,151218,27552
42,5,42005,Pennsylvania,Armstrong County,31413,31779,349,240,72,117,259,265,63192,144,698,524
42,7,42007,Pennsylvania,Beaver County,72142,76189,5166,5412,371,598,1455,1470,148331,742,10332,2925
42,9,42009,Pennsylvania,Bedford County,23211,23548,192,129,88,125,358,243,46759,176,384,601
42,11,42011,Pennsylvania,Berks County,179646,186349,15712,15291,3098,3593,47523,47033,365995,6196,31424,94556
42,13,42013,Pennsylvania,Blair County,56785,59647,1395,1067,408,446,882,749,116432,816,2790,1631
42,15,42015,Pennsylvania,Bradford County,29011,29455,298,190,154,243,496,460,58466,308,596,956
42,17,42017,Pennsylvania,Bucks County,271926,281643,13795,14386,15686,17275,18258,17402,553569,31372,27590,35660
42,19,42019,Pennsylvania,Butler County,88941,91071,1535,1023,1379,1366,1578,1447,180012,2758,3070,3025
42,21,42021,Pennsylvania,Cambria County,59894,62366,2678,2165,325,342,1238,1058,122260,650,5356,2296
42,23,42023,Pennsylvania,Cameron County,2152,2139,26,23,7,11,34,33,4291,14,52,67
42,25,42025,Pennsylvania,Carbon County,30424,30781,820,670,150,240,1790,1612,61205,300,1640,3402
42,27,42027,Pennsylvania,Centre County,74103,68587,4096,2073,5561,4851,2738,2173,142690,11122,8192,4911
42,29,42029,Pennsylvania,Chester County,220387,227251,16107,16623,15763,16423,21001,19046,447638,31526,32214,40047
42,31,42031,Pennsylvania,Clarion County,18209,18943,278,212,116,148,210,209,37152,232,556,419
42,33,42033,Pennsylvania,Clearfield County,38726,36654,2232,178,289,215,2092,368,75380,578,4464,2460
42,35,42035,Pennsylvania,Clinton County,18189,18983,386,257,118,167,349,281,37172,236,772,630
42,37,42037,Pennsylvania,Columbia County,29783,32144,653,657,364,388,968,968,61927,728,1306,1936
42,39,42039,Pennsylvania,Crawford County,39850,41241,707,980,231,306,551,644,81091,462,1414,1195
42,41,42041,Pennsylvania,Cumberland County,109129,113886,7016,4861,6154,5962,5716,5280,223015,12308,14032,10996
42,43,42043,Pennsylvania,Dauphin County,96900,101993,25457,28006,7185,7638,13645,13911,198893,14370,50914,27556
42,45,42045,Pennsylvania,Delaware County,188819,199311,59671,69178,17517,17945,11774,11516,388130,35034,119342,23290
42,47,42047,Pennsylvania,Elk County,14689,14596,100,52,57,72,140,115,29285,114,200,255
42,49,42049,Pennsylvania,Erie County,115838,119976,11133,9960,2593,2649,6069,5835,235814,5186,22266,11904
42,51,42051,Pennsylvania,Fayette County,58795,60897,3709,2494,227,297,966,717,119692,454,7418,1683
42,53,42053,Pennsylvania,Forest County,3409,2197,1515,11,9,4,447,45,5606,18,3030,492
42,55,42055,Pennsylvania,Franklin County,70035,73006,3565,2887,717,974,5006,4447,143041,1434,7130,9453
42,57,42057,Pennsylvania,Fulton County,7096,6979,79,105,14,22,106,80,14075,28,158,186
42,59,42059,Pennsylvania,Greene County,17301,16883,1207,136,75,56,389,188,34184,150,2414,577
42,61,42061,Pennsylvania,Huntingdon County,21128,20313,2445,248,154,193,657,277,41441,308,4890,934
42,63,42063,Pennsylvania,Indiana County,39465,40207,1630,734,393,525,650,496,79672,786,3260,1146
42,65,42065,Pennsylvania,Jefferson County,21136,21349,133,105,54,74,210,202,42485,108,266,412
42,67,42067,Pennsylvania,Juniata County,12062,11983,128,91,38,72,609,447,24045,76,256,1056
42,69,42069,Pennsylvania,Lackawanna County,91602,98036,4723,4004,3236,3351,8871,8731,189638,6472,9446,17602
42,71,42071,Pennsylvania,Lancaster County,238962,250290,14667,13670,6550,7302,29783,30048,489252,13100,29334,59831
42,73,42073,Pennsylvania,Lawrence County,38407,41011,1846,1879,171,231,739,637,79418,342,3692,1376
42,75,42075,Pennsylvania,Lebanon County,64380,66931,2950,2349,909,1275,10176,9882,131311,1818,5900,20058
42,77,42077,Pennsylvania,Lehigh County,148812,155630,18354,18282,6876,7096,48620,48300,304442,13752,36708,96920
42,79,42079,Pennsylvania,Luzerne County,138986,144353,11798,9205,2045,2466,22385,21355,283339,4090,23596,43740
42,81,42081,Pennsylvania,Lycoming County,51200,53005,2528,2925,363,399,1205,1231,104205,726,5056,2436
42,83,42083,Pennsylvania,McKean County,19499,19206,891,135,132,112,615,260,38705,264,1782,875
42,85,42085,Pennsylvania,Mercer County,49099,50786,3521,2887,354,433,1007,752,99885,708,7042,1759
42,87,42087,Pennsylvania,Mifflin County,21813,22950,257,180,140,164,389,389,44763,280,514,778
42,89,42089,Pennsylvania,Monroe County,65470,66318,13858,14052,2135,2382,14424,14442,131788,4270,27716,28866
42,91,42091,Pennsylvania,Montgomery County,320936,338414,40319,42685,32440,34846,23145,22017,659350,64880,80638,45162
42,93,42093,Pennsylvania,Montour County,8161,8834,218,118,304,322,257,270,16995,608,436,527
42,95,42095,Pennsylvania,Northampton County,130126,134982,11070,10882,4659,4669,21565,21635,265108,9318,22140,43200
42,97,42097,Pennsylvania,Northumberland County,42612,43497,2049,702,192,238,1892,1688,86109,384,4098,3580
42,99,42099,Pennsylvania,Perry County,22539,22227,362,174,102,123,546,514,44766,204,724,1060
42,101,42101,Pennsylvania,Philadelphia County,347559,362779,314849,375051,58746,65132,119459,121966,710338,117492,629698,241425
42,103,42103,Pennsylvania,Pike County,25326,24544,1894,1714,344,549,3266,3197,49870,688,3788,6463
42,105,42105,Pennsylvania,Potter County,8019,8085,77,46,21,45,120,124,16104,42,154,244
42,107,42107,Pennsylvania,Schuylkill County,66785,66180,3948,1197,387,470,4225,3124,132965,774,7896,7349
42,109,42109,Pennsylvania,Snyder County,19312,19672,318,252,124,172,469,424,38984,248,636,893
42,111,42111,Pennsylvania,Somerset County,35695,34350,2169,109,180,206,792,356,70045,360,4338,1148
42,113,42113,Pennsylvania,Sullivan County,2927,2784,187,47,10,14,80,31,5711,20,374,111
42,115,42115,Pennsylvania,Susquehanna County,19759,19584,146,136,72,76,372,343,39343,144,292,715
42,117,42117,Pennsylvania,Tioga County,19595,19852,155,154,76,150,263,261,39447,152,310,524
42,119,42119,Pennsylvania,Union County,20542,19298,3003,366,401,372,2163,555,39840,802,6006,2718
42,121,42121,Pennsylvania,Venango County,24173,24876,396,185,95,144,307,252,49049,190,792,559
42,123,42123,Pennsylvania,Warren County,19140,19107,134,87,72,113,234,216,38247,144,268,450
42,125,42125,Pennsylvania,Washington County,94738,98354,3657,3233,1141,1282,2036,1720,193092,2282,7314,3756
42,127,42127,Pennsylvania,Wayne County,25053,23246,1632,261,167,205,1511,983,48299,334,3264,2494
42,129,42129,Pennsylvania,Westmoreland County,161222,169112,4850,4218,1610,1807,2356,2128,330334,3220,9700,4484
42,131,42131,Pennsylvania,Wyoming County,13058,12966,150,119,54,81,285,253,26024,108,300,538
42,133,42133,Pennsylvania,York County,196588,201627,16169,15507,3070,3773,18539,17726,398215,6140,32338,36265
44,1,44001,Rhode Island,Bristol County,21911,23510,394,324,533,663,817,758,45421,1066,788,1575
44,3,44003,Rhode Island,Kent County,72727,78198,2159,1897,2305,2469,4728,4568,150925,4610,4318,9296
44,5,44005,Rhode Island,Newport County,36254,37694,1993,1600,794,810,2600,2286,73948,1588,3986,4886
44,7,44007,Rhode Island,Providence County,242526,255256,39121,40737,14141,15267,76736,75870,497782,28282,78242,152606
44,9,44009,Rhode Island,Washington County,56686,60756,1014,869,1181,1373,2071,2210,117442,2362,2028,4281
45,1,45001,South Carolina,Abbeville County,8432,8791,3178,3598,35,54,210,192,17223,70,6356,402
45,3,45003,South Carolina,Aiken County,59109,61626,20052,23141,971,1151,5471,4616,120735,1942,40104,10087
45,5,45005,South Carolina,Allendale County,1222,945,3189,3140,41,33,186,136,2167,82,6378,322
45,7,45007,South Carolina,Anderson County,78908,84228,15373,17587,937,1174,4027,4053,163136,1874,30746,8080
45,9,45009,South Carolina,Bamberg County,2637,2655,3952,4526,37,39,171,149,5292,74,7904,320
45,11,45011,South Carolina,Barnwell County,5410,5595,4232,4933,82,124,333,225,11005,164,8464,558
45,13,45013,South Carolina,Beaufort County,74218,76001,16168,18128,1257,1535,11140,10179,150219,2514,32336,21319
45,15,45015,South Carolina,Berkeley County,79100,78134,26711,29481,2893,3250,8274,7629,157234,5786,53422,15903
45,17,45017,South Carolina,Calhoun County,4167,4195,2654,3213,20,26,302,267,8362,40,5308,569
45,19,45019,South Carolina,Charleston County,140877,145631,49926,58268,3529,4077,11490,10281,286508,7058,99852,21771
45,21,45021,South Carolina,Cherokee County,21562,22223,5399,6415,164,187,1410,1245,43785,328,10798,2655
45,23,45023,South Carolina,Chester County,9506,9860,5546,6319,69,105,410,315,19366,138,11092,725
45,25,45025,South Carolina,Chesterfield County,14393,14722,7018,7936,135,155,1292,806,29115,270,14036,2098
45,27,45027,South Carolina,Clarendon County,8500,8532,7650,8298,135,143,559,526,17032,270,15300,1085
45,29,45029,South Carolina,Colleton County,11107,11388,6387,7581,84,97,654,576,22495,168,12774,1230
45,31,45031,South Carolina,Darlington County,18045,19288,12542,15250,162,156,759,686,37333,324,25084,1445
45,33,45033,South Carolina,Dillon County,6849,7496,6746,7663,72,106,412,452,14345,144,13492,864
45,35,45035,South Carolina,Dorchester County,55023,56626,19654,21983,1574,1837,4706,4689,111649,3148,39308,9395
45,37,45037,South Carolina,Edgefield County,9014,7965,5166,4399,78,73,1249,441,16979,156,10332,1690
45,39,45039,South Carolina,Fairfield County,4426,4546,5929,6803,93,74,284,244,8972,186,11858,528
45,41,45041,South Carolina,Florence County,35451,38230,26805,32882,1085,1142,1979,1910,73681,2170,53610,3889
45,43,45043,South Carolina,Georgetown County,20370,21980,8630,10440,158,185,1155,835,42350,316,17260,1990
45,45,45045,South Carolina,Greenville County,195237,204140,45397,51186,6599,7518,25835,23957,399377,13198,90794,49792
45,47,45047,South Carolina,Greenwood County,21677,23851,10199,12640,418,526,2259,2123,45528,836,20398,4382
45,49,45049,South Carolina,Hampton County,4451,4051,5104,5095,58,61,562,239,8502,116,10208,801
45,51,45051,South Carolina,Horry County,141597,151887,21642,24147,2075,2878,11290,10301,293484,4150,43284,21591
45,53,45053,South Carolina,Jasper County,8544,8225,6055,6200,103,170,2433,1762,16769,206,12110,4195
45,55,45055,South Carolina,Kershaw County,23494,24803,7577,8625,228,280,1635,1598,48297,456,15154,3233
45,57,45057,South Carolina,Lancaster County,35754,37826,10197,10748,686,846,2903,2832,73580,1372,20394,5735
45,59,45059,South Carolina,Laurens County,23718,24865,7971,9054,170,236,1864,1716,48583,340,15942,3580
45,61,45061,South Carolina,Lee County,2940,2869,5411,5252,39,39,245,184,5809,78,10822,429
45,63,45063,South Carolina,Lexington County,116216,121215,21961,24951,3182,3420,10052,8742,237431,6364,43922,18794
45,65,45065,South Carolina,McCormick County,2660,2416,2347,1861,23,35,85,51,5076,46,4694,136
45,67,45067,South Carolina,Marion County,5932,6438,7679,9731,91,113,511,382,12370,182,15358,893
45,69,45069,South Carolina,Marlboro County,5523,5221,7075,6276,60,57,686,207,10744,120,14150,893
45,71,45071,South Carolina,Newberry County,12433,13037,5611,6050,148,110,1594,1419,25470,296,11222,3013
45,73,45073,South Carolina,Oconee County,35008,35994,2930,3091,319,402,2474,2156,71002,638,5860,4630
45,75,45075,South Carolina,Orangeburg County,14497,15499,24428,29053,372,433,1076,964,29996,744,48856,2040
45,77,45077,South Carolina,Pickens County,55917,56515,4496,4638,1455,1084,2755,2245,112432,2910,8992,5000
45,79,45079,South Carolina,Richland County,94495,94137,93884,108645,6208,6267,11562,10668,188632,12416,187768,22230
45,81,45081,South Carolina,Saluda County,7239,7049,2604,2726,32,42,1932,1313,14288,64,5208,3245
45,83,45083,South Carolina,Spartanburg County,116333,120334,31101,35771,3849,4418,12350,10954,236667,7698,62202,23304
45,85,45085,South Carolina,Sumter County,25668,25445,23581,27495,620,928,2390,2079,51113,1240,47162,4469
45,87,45087,South Carolina,Union County,8537,9321,4040,4701,44,59,246,235,17858,88,8080,481
45,89,45089,South Carolina,Williamsburg County,4931,5077,9069,10523,145,118,496,189,10008,290,18138,685
45,91,45091,South Carolina,York County,102471,107578,24998,29310,3794,4019,8353,8289,210049,7588,49996,16642
46,3,46003,South Dakota,Aurora County,1365,1227,11,7,13,6,127,70,2592,26,22,197
46,5,46005,South Dakota,Beadle County,7905,7640,171,112,907,954,1110,869,15545,1814,342,1979
46,7,46007,South Dakota,Bennett County,593,561,12,10,6,13,117,91,1154,12,24,208
46,9,46009,South Dakota,Bon Homme County,3429,2685,79,17,6,12,148,66,6114,12,158,214
46,11,46011,South Dakota,Brookings County,16590,15932,301,196,571,421,651,575,32522,1142,602,1226
46,13,46013,South Dakota,Brown County,16997,17562,516,419,568,520,753,630,34559,1136,1032,1383
46,15,46015,South Dakota,Brule County,2263,2247,22,10,8,12,88,83,4510,16,44,171
46,17,46017,South Dakota,Buffalo County,158,148,12,3,0,1,60,45,306,0,24,105
46,19,46019,South Dakota,Butte County,4990,4799,31,23,21,24,208,184,9789,42,62,392
46,21,46021,South Dakota,Campbell County,694,641,1,2,3,4,19,18,1335,6,2,37
46,23,46023,South Dakota,Charles Mix County,2914,2936,36,22,8,16,200,145,5850,16,72,345
46,25,46025,South Dakota,Clark County,1829,1767,46,11,20,4,74,57,3596,40,92,131
46,27,46027,South Dakota,Clay County,6244,6330,159,74,186,190,237,207,12574,372,318,444
46,29,46029,South Dakota,Codington County,13246,13144,146,76,69,131,385,297,26390,138,292,682
46,31,46031,South Dakota,Corson County,626,607,13,8,16,8,113,103,1233,32,26,216
46,33,46033,South Dakota,Custer County,4123,4203,30,23,28,25,201,192,8326,56,60,393
46,35,46035,South Dakota,Davison County,9165,9200,116,72,48,85,418,315,18365,96,232,733
46,37,46037,South Dakota,Day County,2391,2322,15,8,8,26,70,65,4713,16,30,135
46,39,46039,South Dakota,Deuel County,2199,2023,23,12,3,6,108,62,4222,6,46,170
46,41,46041,South Dakota,Dewey County,609,600,23,13,6,7,171,121,1209,12,46,292
46,43,46043,South Dakota,Douglas County,1387,1392,11,4,1,2,29,30,2779,2,22,59
46,45,46045,South Dakota,Edmunds County,1856,1851,8,5,8,20,45,40,3707,16,16,85
46,47,46047,South Dakota,Fall River County,2937,2891,61,24,42,68,144,114,5828,84,122,258
46,49,46049,South Dakota,Faulk County,1129,1120,9,8,2,7,7,16,2249,4,18,23
46,51,46051,South Dakota,Grant County,3558,3231,24,14,9,17,241,112,6789,18,48,353
46,53,46053,South Dakota,Gregory County,1912,1797,13,5,5,16,46,25,3709,10,26,71
46,55,46055,South Dakota,Haakon County,871,896,2,3,3,2,17,16,1767,6,4,33
46,57,46057,South Dakota,Hamlin County,3050,2925,24,11,9,15,162,114,5975,18,48,276
46,59,46059,South Dakota,Hand County,1566,1557,3,2,4,9,22,21,3123,8,6,43
46,61,46061,South Dakota,Hanson County,1667,1665,20,9,10,6,26,25,3332,20,40,51
46,63,46063,South Dakota,Harding County,636,584,15,2,2,1,20,14,1220,4,30,34
46,65,46065,South Dakota,Hughes County,7249,7404,74,51,61,76,290,269,14653,122,148,559
46,67,46067,South Dakota,Hutchinson County,3443,3571,56,21,8,10,85,82,7014,16,112,167
46,69,46069,South Dakota,Hyde County,586,552,5,5,1,2,10,9,1138,2,10,19
46,71,46071,South Dakota,Jackson County,719,631,22,12,1,3,73,60,1350,2,44,133
46,73,46073,South Dakota,Jerauld County,978,977,6,1,2,3,57,37,1955,4,12,94
46,75,46075,South Dakota,Jones County,415,395,2,1,0,0,13,11,810,0,4,24
46,77,46077,South Dakota,Kingsbury County,2443,2312,17,8,9,26,67,58,4755,18,34,125
46,79,46079,South Dakota,Lake County,6317,5801,104,57,51,63,186,163,12118,102,208,349
46,81,46081,South Dakota,Lawrence County,12088,12039,143,70,159,162,509,391,24127,318,286,900
46,83,46083,South Dakota,Lincoln County,28424,29155,626,458,453,454,742,734,57579,906,1252,1476
46,85,46085,South Dakota,Lyman County,1104,988,13,9,8,6,38,59,2092,16,26,97
46,87,46087,South Dakota,McCook County,2676,2700,28,12,5,8,123,115,5376,10,56,238
46,89,46089,South Dakota,McPherson County,1155,1158,10,6,5,4,15,22,2313,10,20,37
46,91,46091,South Dakota,Marshall County,2283,2048,26,9,7,3,275,122,4331,14,52,397
46,93,46093,South Dakota,Meade County,13322,12322,372,189,136,156,708,525,25644,272,744,1233
46,95,46095,South Dakota,Mellette County,398,381,10,0,1,4,36,36,779,2,20,72
46,97,46097,South Dakota,Miner County,1100,1037,15,2,2,8,34,37,2137,4,30,71
46,99,46099,South Dakota,Minnehaha County,83638,82912,6626,5224,1961,2144,5320,4616,166550,3922,13252,9936
46,101,46101,South Dakota,Moody County,2616,2603,65,25,49,89,159,142,5219,98,130,301
46,102,46102,South Dakota,Oglala Lakota County,394,365,36,22,9,10,306,273,759,18,72,579
46,103,46103,South Dakota,Pennington County,47688,46909,993,627,650,770,3097,3028,94597,1300,1986,6125
46,105,46105,South Dakota,Perkins County,1365,1357,10,5,6,5,28,21,2722,12,20,49
46,107,46107,South Dakota,Potter County,1003,1021,5,7,3,15,30,21,2024,6,10,51
46,109,46109,South Dakota,Roberts County,3079,2847,52,30,10,16,210,187,5926,20,104,397
46,111,46111,South Dakota,Sanborn County,1177,1096,6,3,3,2,39,35,2273,6,12,74
46,115,46115,South Dakota,Spink County,3024,3060,23,22,2,9,149,68,6084,4,46,217
46,117,46117,South Dakota,Stanley County,1411,1324,16,7,2,6,39,35,2735,4,32,74
46,119,46119,South Dakota,Sully County,686,630,4,2,2,0,20,14,1316,4,8,34
46,121,46121,South Dakota,Todd County,424,393,30,33,90,149,226,197,817,180,60,423
46,123,46123,South Dakota,Tripp County,2175,2204,18,13,7,13,80,64,4379,14,36,144
46,125,46125,South Dakota,Turner County,4064,4053,31,20,9,11,113,108,8117,18,62,221
46,127,46127,South Dakota,Union County,7566,7457,145,97,124,110,306,285,15023,248,290,591
46,129,46129,South Dakota,Walworth County,2197,2151,16,12,48,56,72,60,4348,96,32,132
46,135,46135,South Dakota,Yankton County,10719,10235,406,88,103,93,711,453,20954,206,812,1164
46,137,46137,South Dakota,Ziebach County,344,330,11,4,3,5,62,47,674,6,22,109
47,1,47001,Tennessee,Anderson County,34285,36191,1590,1564,548,624,1273,1162,70476,1096,3180,2435
47,3,47003,Tennessee,Bedford County,21209,22044,2134,2065,262,258,3354,3146,43253,524,4268,6500
47,5,47005,Tennessee,Benton County,7469,7818,222,197,41,57,216,217,15287,82,444,433
47,7,47007,Tennessee,Bledsoe County,7665,5882,1106,54,25,20,266,161,13547,50,2212,427
47,9,47009,Tennessee,Blount County,60489,64273,2111,1909,539,761,2545,2270,124762,1078,4222,4815
47,11,47011,Tennessee,Bradley County,47589,50492,2876,2760,558,786,3821,3347,98081,1116,5752,7168
47,13,47013,Tennessee,Campbell County,19050,19776,121,88,73,84,275,344,38826,146,242,619
47,15,47015,Tennessee,Cannon County,6989,7084,156,105,24,30,186,177,14073,48,312,363
47,17,47017,Tennessee,Carroll County,11673,12374,1474,1339,55,69,413,396,24047,110,2948,809
47,19,47019,Tennessee,Carter County,26544,27635,562,396,94,142,590,540,54179,188,1124,1130
47,21,47021,Tennessee,Cheatham County,19141,19524,455,408,67,112,729,645,38665,134,910,1374
47,23,47023,Tennessee,Chester County,7246,7871,787,847,54,62,227,271,15117,108,1574,498
47,25,47025,Tennessee,Claiborne County,15060,15670,185,167,113,188,235,224,30730,226,370,459
47,27,47027,Tennessee,Clay County,3601,3740,64,58,3,4,108,85,7341,6,128,193
47,29,47029,Tennessee,Cocke County,16559,17648,397,363,77,94,483,449,34207,154,794,932
47,31,47031,Tennessee,Coffee County,25345,26673,1127,1106,286,366,1343,1308,52018,572,2254,2651
47,33,47033,Tennessee,Crockett County,5590,6172,964,1047,25,26,791,769,11762,50,1928,1560
47,35,47035,Tennessee,Cumberland County,28612,30027,246,193,138,233,998,907,58639,276,492,1905
47,37,47037,Tennessee,Davidson County,223096,231394,87477,102822,13151,14316,38120,34098,454490,26302,174954,72218
47,39,47039,Tennessee,Decatur County,5370,5660,189,166,42,31,220,196,11030,84,378,416
47,41,47041,Tennessee,DeKalb County,9671,9759,236,171,62,162,991,765,19430,124,472,1756
47,43,47043,Tennessee,Dickson County,24422,25557,1172,1034,167,192,1069,1021,49979,334,2344,2090
47,45,47045,Tennessee,Dyer County,14855,15802,2516,2871,126,151,712,619,30657,252,5032,1331
47,47,47047,Tennessee,Fayette County,14407,14518,5445,5875,139,144,661,593,28925,278,10890,1254
47,49,47049,Tennessee,Fentress County,8895,9178,42,48,32,33,141,150,18073,64,84,291
47,51,47051,Tennessee,Franklin County,18849,19672,1148,1065,155,243,850,715,38521,310,2296,1565
47,53,47053,Tennessee,Gibson County,18951,20077,4067,4807,94,82,750,625,39028,188,8134,1375
47,55,47055,Tennessee,Giles County,12319,13126,1500,1534,92,72,446,447,25445,184,3000,893
47,57,47057,Tennessee,Grainger County,11367,11260,116,107,30,36,476,316,22627,60,232,792
47,59,47059,Tennessee,Greene County,32306,33597,856,677,190,213,1123,977,65903,380,1712,2100
47,61,47061,Tennessee,Grundy County,6469,6556,53,36,23,29,87,90,13025,46,106,177
47,63,47063,Tennessee,Hamblen County,28972,30343,1468,1433,277,394,4202,3672,59315,554,2936,7874
47,65,47065,Tennessee,Hamilton County,136148,143146,32648,38508,3995,3978,11744,10448,279294,7990,65296,22192
47,67,47067,Tennessee,Hancock County,3168,3262,19,19,3,13,29,16,6430,6,38,45
47,69,47069,Tennessee,Hardeman County,7539,6284,5967,4610,99,95,252,202,13823,198,11934,454
47,71,47071,Tennessee,Hardin County,11705,12390,419,439,66,80,393,293,24095,132,838,686
47,73,47073,Tennessee,Hawkins County,26924,27777,460,391,114,199,490,458,54701,228,920,948
47,75,47075,Tennessee,Haywood County,3990,4194,3944,4817,23,27,377,359,8184,46,7888,736
47,77,47077,Tennessee,Henderson County,12235,12926,1143,1037,46,55,415,287,25161,92,2286,702
47,79,47079,Tennessee,Henry County,14012,14916,1193,1261,78,101,482,456,28928,156,2386,938
47,81,47081,Tennessee,Hickman County,11923,11323,1002,259,30,61,383,281,23246,60,2004,664
47,83,47083,Tennessee,Houston County,3781,3914,137,106,19,22,102,101,7695,38,274,203
47,85,47085,Tennessee,Humphreys County,8721,8813,302,218,32,60,252,231,17534,64,604,483
47,87,47087,Tennessee,Jackson County,5722,5719,39,34,6,11,125,131,11441,12,78,256
47,89,47089,Tennessee,Jefferson County,25463,26396,659,483,167,220,1148,922,51859,334,1318,2070
47,91,47091,Tennessee,Johnson County,9000,8050,358,41,19,30,201,174,17050,38,716,375
47,93,47093,Tennessee,Knox County,196579,207415,20054,21959,5754,5672,10940,10524,403994,11508,40108,21464
47,95,47095,Tennessee,Lake County,2881,1980,1420,542,9,8,121,61,4861,18,2840,182
47,97,47097,Tennessee,Lauderdale County,8114,7750,4777,4208,76,67,396,299,15864,152,9554,695
47,99,47099,Tennessee,Lawrence County,20665,21459,460,343,105,117,596,468,42124,210,920,1064
47,101,47101,Tennessee,Lewis County,5678,5979,150,105,31,48,151,152,11657,62,300,303
47,103,47103,Tennessee,Lincoln County,15025,15676,1153,1251,80,99,746,556,30701,160,2306,1302
47,105,47105,Tennessee,Loudon County,25389,26208,473,381,204,293,2719,2268,51597,408,946,4987
47,107,47107,Tennessee,McMinn County,24222,25548,1056,1059,186,226,1114,1292,49770,372,2112,2406
47,109,47109,Tennessee,McNairy County,11481,12007,787,780,41,59,306,277,23488,82,1574,583
47,111,47111,Tennessee,Macon County,11524,12044,172,123,32,162,653,603,23568,64,344,1256
47,113,47113,Tennessee,Madison County,27738,29980,17030,19924,538,620,2075,1915,57718,1076,34060,3990
47,115,47115,Tennessee,Marion County,13194,13719,574,601,90,103,326,258,26913,180,1148,584
47,117,47117,Tennessee,Marshall County,15150,15896,1128,1113,137,101,1019,953,31046,274,2256,1972
47,119,47119,Tennessee,Maury County,39449,41621,5369,6196,384,557,3099,2904,81070,768,10738,6003
47,121,47121,Tennessee,Meigs County,5863,5999,108,95,19,23,139,141,11862,38,216,280
47,123,47123,Tennessee,Monroe County,21913,22215,543,488,89,115,1197,967,44128,178,1086,2164
47,125,47125,Tennessee,Montgomery County,73837,73298,22042,22540,1944,2885,11102,10310,147135,3888,44084,21412
47,127,47127,Tennessee,Moore County,3016,3083,93,70,21,100,54,62,6099,42,186,116
47,129,47129,Tennessee,Morgan County,10701,9411,737,53,24,36,169,147,20112,48,1474,316
47,131,47131,Tennessee,Obion County,12594,13444,1552,1700,56,79,741,700,26038,112,3104,1441
47,133,47133,Tennessee,Overton County,10743,10895,91,59,35,49,213,156,21638,70,182,369
47,135,47135,Tennessee,Perry County,3808,3761,115,77,15,52,114,105,7569,30,230,219
47,137,47137,Tennessee,Pickett County,2463,2494,8,8,3,3,65,49,4957,6,16,114
47,139,47139,Tennessee,Polk County,8029,8201,77,43,23,38,188,197,16230,46,154,385
47,141,47141,Tennessee,Putnam County,36989,37899,1076,851,682,579,2684,2551,74888,1364,2152,5235
47,143,47143,Tennessee,Rhea County,15543,15846,403,317,92,125,993,733,31389,184,806,1726
47,145,47145,Tennessee,Roane County,24713,25596,741,725,138,199,537,539,50309,276,1482,1076
47,147,47147,Tennessee,Robertson County,31629,32308,2673,2931,262,264,2809,2524,63937,524,5346,5333
47,149,47149,Tennessee,Rutherford County,125798,128832,25851,28205,5889,6234,14924,13926,254630,11778,51702,28850
47,151,47151,Tennessee,Scott County,10623,11005,36,32,31,35,136,108,21628,62,72,244
47,153,47153,Tennessee,Sequatchie County,7159,7325,68,49,30,39,298,253,14484,60,136,551
47,155,47155,Tennessee,Sevier County,45635,47728,770,606,564,641,3451,2884,93363,1128,1540,6335
47,157,47157,Tennessee,Shelby County,188738,194488,233900,274713,12638,13765,32661,29465,383226,25276,467800,62126
47,159,47159,Tennessee,Smith County,9528,9672,253,203,38,53,311,312,19200,76,506,623
47,161,47161,Tennessee,Stewart County,6452,6472,149,110,61,83,259,221,12924,122,298,480
47,163,47163,Tennessee,Sullivan County,72886,77300,2027,1673,520,739,1661,1559,150186,1040,4054,3220
47,165,47165,Tennessee,Sumner County,82063,85594,7535,8263,1424,1634,5169,4978,167657,2848,15070,10147
47,167,47167,Tennessee,Tipton County,23791,24187,5555,5845,163,323,1023,755,47978,326,11110,1778
47,169,47169,Tennessee,Trousdale County,5612,4045,881,403,12,42,144,140,9657,24,1762,284
47,171,47171,Tennessee,Unicoi County,8600,8822,63,31,15,31,532,448,17422,30,126,980
47,173,47173,Tennessee,Union County,9660,9798,50,53,15,21,191,181,19458,30,100,372
47,175,47175,Tennessee,Van Buren County,2882,2804,30,24,3,10,58,61,5686,6,60,119
47,177,47177,Tennessee,Warren County,19006,19348,840,736,176,180,2304,1591,38354,352,1680,3895
47,179,47179,Tennessee,Washington County,57522,60581,2997,2763,1021,1171,2418,2268,118103,2042,5994,4686
47,181,47181,Tennessee,Wayne County,8031,7216,1044,77,24,19,229,133,15247,48,2088,362
47,183,47183,Tennessee,Weakley County,14440,15179,1249,1314,212,194,494,486,29619,424,2498,980
47,185,47185,Tennessee,White County,12749,13376,308,195,50,66,403,370,26125,100,616,773
47,187,47187,Tennessee,Williamson County,103180,107218,5265,5370,6144,6178,5896,5829,210398,12288,10530,11725
47,189,47189,Tennessee,Wilson County,62817,64682,5331,5503,1233,1381,3543,3177,127499,2466,10662,6720
48,1,48001,Texas,Anderson County,24946,18089,9322,3306,325,213,7020,3490,43035,650,18644,10510
48,3,48003,Texas,Andrews County,9009,8632,212,170,68,62,5508,5082,17641,136,424,10590
48,5,48005,Texas,Angelina County,34473,35753,6453,7142,446,477,10020,9680,70226,892,12906,19700
48,7,48007,Texas,Aransas County,10751,11090,247,159,231,260,3384,3176,21841,462,494,6560
48,9,48009,Texas,Archer County,3980,4158,51,45,16,25,364,335,8138,32,102,699
48,11,48011,Texas,Armstrong County,892,925,15,7,2,5,86,87,1817,4,30,173
48,13,48013,Texas,Atascosa County,24248,24507,377,314,158,160,16728,16435,48755,316,754,33163
48,15,48015,Texas,Austin County,13051,13190,1350,1429,117,123,4256,4099,26241,234,2700,8355
48,17,48017,Texas,Bailey County,3209,3236,87,62,41,23,2273,2208,6445,82,174,4481
48,19,48019,Texas,Bandera County,10955,11077,127,129,50,81,2285,2280,22032,100,254,4565
48,21,48021,Texas,Bastrop County,39367,38283,3408,3049,402,422,18359,16830,77650,804,6816,35189
48,23,48023,Texas,Baylor County,1586,1678,53,55,4,13,243,254,3264,8,106,497
48,25,48025,Texas,Bee County,16754,11935,2606,300,101,108,10750,8566,28689,202,5212,19316
48,27,48027,Texas,Bell County,119922,118669,43826,44889,4680,6794,46772,45988,238591,9360,87652,92760
48,29,48029,Texas,Bexar County,834238,853880,86526,85876,30417,35029,596614,619174,1688118,60834,173052,1215788
48,31,48031,Texas,Blanco County,5592,5690,129,54,30,83,1266,1082,11282,60,258,2348
48,33,48033,Texas,Borden County,320,301,6,0,0,1,68,49,621,0,12,117
48,35,48035,Texas,Bosque County,8702,8981,232,174,48,72,1809,1724,17683,96,464,3533
48,37,48037,Texas,Bowie County,32678,32355,11716,11978,512,632,4452,2861,65033,1024,23432,7313
48,39,48039,Texas,Brazoria County,142252,138078,28850,27762,12266,13733,60753,57398,280330,24532,57700,118151
48,41,48041,Texas,Brazos County,91826,90693,12392,13220,7804,6594,30490,29585,182519,15608,24784,60075
48,43,48043,Texas,Brewster County,4329,4167,93,60,74,86,2136,2023,8496,148,186,4159
48,45,48045,Texas,Briscoe County,718,720,24,27,3,1,191,195,1438,6,48,386
48,47,48047,Texas,Brooks County,3484,3359,42,36,46,33,3287,3196,6843,92,84,6483
48,49,48049,Texas,Brown County,17180,17806,850,694,168,136,4433,4302,34986,336,1700,8735
48,51,48051,Texas,Burleson County,7658,7813,1126,1224,54,37,1991,1908,15471,108,2252,3899
48,53,48053,Texas,Burnet County,22185,23175,541,441,196,266,5538,5336,45360,392,1082,10874
48,55,48055,Texas,Caldwell County,19506,19289,1526,1348,226,226,11893,11595,38795,452,3052,23488
48,57,48057,Texas,Calhoun County,9711,9301,343,323,616,519,5391,5131,19012,1232,686,10522
48,59,48059,Texas,Callahan County,6558,6647,124,113,43,54,730,667,13205,86,248,1397
48,61,48061,Texas,Cameron County,199915,210861,1921,1549,1705,1630,184844,196017,410776,3410,3842,380861
48,63,48063,Texas,Camp County,5000,5293,992,1174,89,48,1662,1729,10293,178,1984,3391
48,65,48065,Texas,Carson County,2809,2789,35,30,13,27,283,293,5598,26,70,576
48,67,48067,Texas,Cass County,11649,12378,2398,2719,71,78,708,723,24027,142,4796,1431
48,69,48069,Texas,Castro County,3624,3436,113,89,21,29,2531,2416,7060,42,226,4947
48,71,48071,Texas,Chambers County,19375,19020,1846,1791,275,311,5483,4953,38395,550,3692,10436
48,73,48073,Texas,Cherokee County,21545,21205,4117,3503,148,155,6712,5819,42750,296,8234,12531
48,75,48075,Texas,Childress County,3674,2597,675,116,30,26,1603,715,6271,60,1350,2318
48,77,48077,Texas,Clay County,4984,4961,65,45,13,37,346,376,9945,26,130,722
48,79,48079,Texas,Cochran County,1311,1276,66,60,8,6,892,845,2587,16,132,1737
48,81,48081,Texas,Coke County,1595,1599,22,13,2,3,403,346,3194,4,44,749
48,83,48083,Texas,Coleman County,3835,3694,139,125,38,53,744,690,7529,76,278,1434
48,85,48085,Texas,Collin County,355041,361630,52955,59437,83217,85395,80677,79959,716671,166434,105910,160636
48,87,48087,Texas,Collingsworth County,1273,1293,85,101,7,8,496,498,2566,14,170,994
48,89,48089,Texas,Colorado County,9060,8924,1358,1335,67,85,3429,3160,17984,134,2716,6589
48,91,48091,Texas,Comal County,71973,73222,2243,1946,860,1347,21918,21906,145195,1720,4486,43824
48,93,48093,Texas,Comanche County,6480,6529,90,58,37,54,2021,1882,13009,74,180,3903
48,95,48095,Texas,Concho County,1337,1218,43,17,43,6,557,390,2555,86,86,947
48,97,48097,Texas,Cooke County,18908,19033,809,681,178,249,4074,3733,37941,356,1618,7807
48,99,48099,Texas,Coryell County,27962,27850,6638,6827,670,980,7400,6949,55812,1340,13276,14349
48,101,48101,Texas,Cottle County,582,621,81,75,0,1,179,160,1203,0,162,339
48,103,48103,Texas,Crane County,2220,2203,99,77,20,27,1642,1529,4423,40,198,3171
48,105,48105,Texas,Crockett County,1618,1625,31,24,14,21,1162,1124,3243,28,62,2286
48,107,48107,Texas,Crosby County,2618,2691,115,116,11,7,1645,1605,5309,22,230,3250
48,109,48109,Texas,Culberson County,970,998,26,13,25,21,763,819,1968,50,52,1582
48,111,48111,Texas,Dallam County,3520,3204,113,77,37,39,1860,1605,6724,74,226,3465
48,113,48113,Texas,Dallas County,883177,870958,287945,333402,87977,89258,548047,526148,1754135,175954,575890,1074195
48,115,48115,Texas,Dawson County,6111,5277,560,236,74,96,4025,3375,11388,148,1120,7400
48,117,48117,Texas,Deaf Smith County,8691,8756,226,193,48,69,6940,6821,17447,96,452,13761
48,119,48119,Texas,Delta County,2292,2333,206,152,16,20,268,204,4625,32,412,472
48,121,48121,Texas,Denton County,332455,338412,45960,51849,41746,44078,87138,86767,670867,83492,91920,173905
48,123,48123,Texas,DeWitt County,9150,8594,1122,718,40,42,3972,3319,17744,80,2244,7291
48,125,48125,Texas,Dickens County,1046,907,102,25,17,10,420,251,1953,34,204,671
48,127,48127,Texas,Dimmit County,4710,4983,92,78,36,41,4281,4587,9693,72,184,8868
48,129,48129,Texas,Donley County,1471,1503,95,103,8,11,205,165,2974,16,190,370
48,131,48131,Texas,Duval County,5452,5308,123,37,26,32,5016,4951,10760,52,246,9967
48,133,48133,Texas,Eastland County,8628,8679,230,167,56,82,1647,1474,17307,112,460,3121
48,135,48135,Texas,Ector County,76326,73460,4679,4197,1025,1133,53541,50447,149786,2050,9358,103988
48,137,48137,Texas,Edwards County,973,854,9,14,7,7,591,478,1827,14,18,1069
48,139,48139,Texas,Ellis County,77027,78342,10899,11570,687,882,25515,24190,155369,1374,21798,49705
48,141,48141,Texas,El Paso County,377948,392815,19335,14110,5346,6065,335729,360386,770763,10692,38670,696115
48,143,48143,Texas,Erath County,19557,20536,475,392,214,229,4813,4392,40093,428,950,9205
48,145,48145,Texas,Falls County,6029,6401,1826,2354,51,58,2125,2033,12430,102,3652,4158
48,147,48147,Texas,Fannin County,16455,15182,1587,706,135,143,2524,1723,31637,270,3174,4247
48,149,48149,Texas,Fayette County,11338,11631,771,830,53,63,2739,2711,22969,106,1542,5450
48,151,48151,Texas,Fisher County,1757,1761,80,75,10,10,537,543,3518,20,160,1080
48,153,48153,Texas,Floyd County,2626,2624,123,121,17,14,1718,1648,5250,34,246,3366
48,155,48155,Texas,Foard County,503,560,25,30,2,8,103,113,1063,4,50,216
48,157,48157,Texas,Fort Bend County,222289,221978,81368,91792,82446,87375,100855,101637,444267,164892,162736,202492
48,159,48159,Texas,Franklin County,4881,4948,219,231,54,60,882,734,9829,108,438,1616
48,161,48161,Texas,Freestone County,8053,7665,1716,1408,90,86,1768,1401,15718,180,3432,3169
48,163,48163,Texas,Frio County,10567,7921,699,142,485,71,9438,6778,18488,970,1398,16216
48,165,48165,Texas,Gaines County,10265,10129,291,207,50,39,4726,4416,20394,100,582,9142
48,167,48167,Texas,Galveston County,135838,138747,21394,23880,5507,6424,43712,43140,274585,11014,42788,86852
48,169,48169,Texas,Garza County,3625,1921,295,163,25,22,2332,906,5546,50,590,3238
48,171,48171,Texas,Gillespie County,12667,13375,103,78,63,77,3297,3132,26042,126,206,6429
48,173,48173,Texas,Glasscock County,755,613,11,11,1,1,326,228,1368,2,22,554
48,175,48175,Texas,Goliad County,3436,3606,209,175,20,19,1355,1389,7042,40,418,2744
48,177,48177,Texas,Gonzales County,9333,9173,824,730,45,67,5519,5170,18506,90,1648,10689
48,179,48179,Texas,Gray County,10342,9320,943,293,71,79,3661,2869,19662,142,1886,6530
48,181,48181,Texas,Grayson County,58247,60999,4149,4278,1067,1052,9962,9408,119246,2134,8298,19370
48,183,48183,Texas,Gregg County,45210,47045,12206,13706,832,912,12457,11367,92255,1664,24412,23824
48,185,48185,Texas,Grimes County,12543,10872,2640,1822,59,54,3972,3160,23415,118,5280,7132
48,187,48187,Texas,Guadalupe County,70314,71729,7608,7133,1330,1976,31950,32301,142043,2660,15216,64251
48,189,48189,Texas,Hale County,15493,14629,1225,712,118,107,10374,9805,30122,236,2450,20179
48,191,48191,Texas,Hall County,1253,1329,145,125,6,8,521,520,2582,12,290,1041
48,193,48193,Texas,Hamilton County,3987,4024,51,34,34,39,599,536,8011,68,102,1135
48,195,48195,Texas,Hansford County,2603,2542,32,24,9,14,1399,1261,5145,18,64,2660
48,197,48197,Texas,Hardeman County,1761,1777,129,95,10,12,474,478,3538,20,258,952
48,199,48199,Texas,Hardin County,25954,26764,1557,1675,200,228,1818,1623,52718,400,3114,3441
48,201,48201,Texas,Harris County,1655138,1623551,441146,499700,168062,177344,1050085,1010934,3278689,336124,882292,2061019
48,203,48203,Texas,Harrison County,24701,25182,6590,7459,245,268,4627,4451,49883,490,13180,9078
48,205,48205,Texas,Hartley County,2927,2098,353,39,26,21,1026,530,5025,52,706,1556
48,207,48207,Texas,Haskell County,2700,2439,166,105,32,18,912,707,5139,64,332,1619
48,209,48209,Texas,Hays County,102577,104550,5565,5089,1903,2088,46259,46015,207127,3806,11130,92274
48,211,48211,Texas,Hemphill County,1816,1811,13,19,22,27,683,624,3627,44,26,1307
48,213,48213,Texas,Henderson County,36234,38071,2670,2663,249,309,5782,5436,74305,498,5340,11218
48,215,48215,Texas,Hidalgo County,412435,429994,4361,3386,4457,4621,392574,410881,842429,8914,8722,803455
48,217,48217,Texas,Hill County,16330,16492,1200,1256,101,148,4072,3707,32822,202,2400,7779
48,219,48219,Texas,Hockley County,10614,10746,464,463,76,41,5642,5570,21360,152,928,11212
48,221,48221,Texas,Hood County,28590,30220,383,326,229,316,3975,3923,58810,458,766,7898
48,223,48223,Texas,Hopkins County,16188,16709,1346,1409,139,126,3404,3063,32897,278,2692,6467
48,225,48225,Texas,Houston County,8685,7822,3272,2513,74,114,1663,999,16507,148,6544,2662
48,227,48227,Texas,Howard County,18055,14278,1842,722,275,178,9275,6631,32333,550,3684,15906
48,229,48229,Texas,Hudspeth County,2321,2085,122,66,38,38,1971,1788,4406,76,244,3759
48,231,48231,Texas,Hunt County,42133,43142,3880,4250,716,775,9078,8305,85275,1432,7760,17383
48,233,48233,Texas,Hutchinson County,9718,9484,329,296,74,85,2639,2399,19202,148,658,5038
48,235,48235,Texas,Irion County,744,718,9,10,4,4,212,181,1462,8,18,393
48,237,48237,Texas,Jack County,4580,3718,320,46,31,21,928,623,8298,62,640,1551
48,239,48239,Texas,Jackson County,6573,6612,478,517,82,77,2556,2391,13185,164,956,4947
48,241,48241,Texas,Jasper County,14298,14465,2754,2939,100,109,1331,1098,28763,200,5508,2429
48,243,48243,Texas,Jeff Davis County,1096,1031,16,14,7,27,383,352,2127,14,32,735
48,245,48245,Texas,Jefferson County,77332,71218,42361,43446,5097,4826,30893,24683,148550,10194,84722,55576
48,247,48247,Texas,Jim Hogg County,2590,2460,25,16,14,15,2469,2352,5050,28,50,4821
48,249,48249,Texas,Jim Wells County,19288,19715,278,155,90,151,16078,16335,39003,180,556,32413
48,251,48251,Texas,Johnson County,79831,80500,3975,3410,817,931,20722,19041,160331,1634,7950,39763
48,253,48253,Texas,Jones County,9744,6896,2373,285,116,47,3815,1811,16640,232,4746,5626
48,255,48255,Texas,Karnes County,7645,6123,1286,137,36,44,4950,3853,13768,72,2572,8803
48,257,48257,Texas,Kaufman County,54819,55839,9045,9889,932,1095,16077,15586,110658,1864,18090,31663
48,259,48259,Texas,Kendall County,21954,22859,376,311,283,388,5892,5767,44813,566,752,11659
48,261,48261,Texas,Kenedy County,188,176,12,5,6,1,154,142,364,12,24,296
48,263,48263,Texas,Kent County,362,355,4,5,0,1,82,67,717,0,8,149
48,265,48265,Texas,Kerr County,23652,25684,605,433,281,347,7185,7250,49336,562,1210,14435
48,267,48267,Texas,Kimble County,2030,2143,24,14,16,20,546,535,4173,32,48,1081
48,269,48269,Texas,King County,130,128,0,0,0,0,27,19,258,0,0,46
48,271,48271,Texas,Kinney County,1879,1541,50,30,9,13,1329,949,3420,18,100,2278
48,273,48273,Texas,Kleberg County,14003,13843,732,527,450,287,11163,11348,27846,900,1464,22511
48,275,48275,Texas,Knox County,1598,1691,100,114,6,6,631,645,3289,12,200,1276
48,277,48277,Texas,Lamar County,19521,20732,3109,3624,176,219,2182,2028,40253,352,6218,4210
48,279,48279,Texas,Lamb County,5861,5895,282,316,27,41,3630,3600,11756,54,564,7230
48,281,48281,Texas,Lampasas County,9449,9797,508,399,123,179,2115,2043,19246,246,1016,4158
48,283,48283,Texas,La Salle County,4270,2976,64,55,14,19,3904,2638,7246,28,128,6542
48,285,48285,Texas,Lavaca County,8966,9324,630,683,43,65,2002,1948,18290,86,1260,3950
48,287,48287,Texas,Lee County,7359,7388,1001,859,51,50,2173,2044,14747,102,2002,4217
48,289,48289,Texas,Leon County,7775,7830,637,641,45,72,1408,1209,15605,90,1274,2617
48,291,48291,Texas,Liberty County,37953,38392,4035,4506,269,333,12938,12271,76345,538,8070,25209
48,293,48293,Texas,Limestone County,9493,8926,2068,2030,85,103,2881,2415,18419,170,4136,5296
48,295,48295,Texas,Lipscomb County,1526,1445,46,21,6,19,615,499,2971,12,92,1114
48,297,48297,Texas,Live Oak County,5936,5297,535,49,60,32,2770,2212,11233,120,1070,4982
48,299,48299,Texas,Llano County,10117,10785,139,112,48,83,1150,1208,20902,96,278,2358
48,301,48301,Texas,Loving County,95,65,2,4,1,1,15,8,160,2,4,23
48,303,48303,Texas,Lubbock County,132029,136736,12157,12245,3757,3610,55969,56737,268765,7514,24314,112706
48,305,48305,Texas,Lynn County,2835,2715,87,66,10,11,1462,1321,5550,20,174,2783
48,307,48307,Texas,McCulloch County,3710,3717,135,97,39,28,1379,1259,7427,78,270,2638
48,309,48309,Texas,McLennan County,101024,104250,17824,20237,2147,2352,35046,34200,205274,4294,35648,69246
48,311,48311,Texas,McMullen County,363,332,10,8,1,4,181,132,695,2,20,313
48,313,48313,Texas,Madison County,6020,4844,1896,974,68,46,2155,1300,10864,136,3792,3455
48,315,48315,Texas,Marion County,3659,3686,953,1102,45,47,207,240,7345,90,1906,447
48,317,48317,Texas,Martin County,2693,2705,100,71,15,16,1401,1348,5398,30,200,2749
48,319,48319,Texas,Mason County,2119,2012,20,18,5,9,590,497,4131,10,40,1087
48,321,48321,Texas,Matagorda County,15505,15139,1958,2166,371,335,8202,7652,30644,742,3916,15854
48,323,48323,Texas,Maverick County,28247,28227,248,170,227,190,27929,27925,56474,454,496,55854
48,325,48325,Texas,Medina County,24482,23656,1190,414,206,248,13937,13221,48138,412,2380,27158
48,327,48327,Texas,Menard County,1010,1023,27,10,2,2,409,382,2033,4,54,791
48,329,48329,Texas,Midland County,78769,76550,6181,6024,2024,1988,41718,39624,155319,4048,12362,81342
48,331,48331,Texas,Milam County,10594,10865,1156,1203,90,151,3370,3290,21459,180,2312,6660
48,333,48333,Texas,Mills County,2333,2352,36,21,10,10,455,435,4685,20,72,890
48,335,48335,Texas,Mitchell County,4044,3031,867,156,38,27,2194,1277,7075,76,1734,3471
48,337,48337,Texas,Montague County,9256,9657,106,61,42,55,1100,1114,18913,84,212,2214
48,339,48339,Texas,Montgomery County,265043,268602,17289,18249,9198,10586,77154,75683,533645,18396,34578,152837
48,341,48341,Texas,Moore County,9170,8871,634,251,681,624,6218,5776,18041,1362,1268,11994
48,343,48343,Texas,Morris County,4348,4663,1303,1453,30,53,665,657,9011,60,2606,1322
48,345,48345,Texas,Motley County,563,556,25,11,1,1,125,106,1119,2,50,231
48,347,48347,Texas,Nacogdoches County,24723,25886,5342,6543,362,502,6703,6343,50609,724,10684,13046
48,349,48349,Texas,Navarro County,20083,20517,3153,3524,191,210,7230,7073,40600,382,6306,14303
48,351,48351,Texas,Newton County,5326,5105,1413,1270,52,27,300,234,10431,104,2826,534
48,353,48353,Texas,Nolan County,6635,6677,386,385,52,66,2890,2863,13312,104,772,5753
48,355,48355,Texas,Nueces County,162503,166750,7954,7515,3683,4383,114678,118969,329253,7366,15908,233647
48,357,48357,Texas,Ochiltree County,4657,4643,78,57,37,30,2811,2640,9300,74,156,5451
48,359,48359,Texas,Oldham County,1018,909,44,35,10,20,194,168,1927,20,88,362
48,361,48361,Texas,Orange County,36199,36699,3568,3799,446,541,3702,3372,72898,892,7136,7074
48,363,48363,Texas,Palo Pinto County,13365,13908,393,349,152,137,2986,2898,27273,304,786,5884
48,365,48365,Texas,Panola County,9369,9314,1734,1910,60,146,1137,970,18683,120,3468,2107
48,367,48367,Texas,Parker County,67341,68143,1323,1053,410,569,9672,8935,135484,820,2646,18607
48,369,48369,Texas,Parmer County,4647,4377,94,77,36,56,3275,2943,9024,72,188,6218
48,371,48371,Texas,Pecos County,8043,6427,612,103,97,106,5861,5063,14470,194,1224,10924
48,373,48373,Texas,Polk County,23265,20405,3273,1890,185,251,4898,3077,43670,370,6546,7975
48,375,48375,Texas,Potter County,47061,46191,7518,5529,3614,3236,23559,22307,93252,7228,15036,45866
48,377,48377,Texas,Presidio County,3097,3086,63,34,155,55,2755,2739,6183,310,126,5494
48,379,48379,Texas,Rains County,5825,5875,173,166,49,57,607,572,11700,98,346,1179
48,381,48381,Texas,Randall County,61437,64503,2736,2148,1180,1312,15988,15784,125940,2360,5472,31772
48,383,48383,Texas,Reagan County,1890,1650,81,55,13,11,1472,1246,3540,26,162,2718
48,385,48385,Texas,Real County,1598,1657,21,16,9,5,503,458,3255,18,42,961
48,387,48387,Texas,Red River County,4660,4884,925,1067,23,22,448,392,9544,46,1850,840
48,389,48389,Texas,Reeves County,8736,5767,713,174,144,104,6973,4953,14503,288,1426,11926
48,391,48391,Texas,Refugio County,3033,3208,253,182,32,30,1736,1780,6241,64,506,3516
48,393,48393,Texas,Roberts County,411,408,0,1,0,2,53,41,819,0,0,94
48,395,48395,Texas,Robertson County,6502,6493,1575,1869,82,63,1871,1865,12995,164,3150,3736
48,397,48397,Texas,Rockwall County,44681,45832,3971,3812,1537,1845,10006,9536,90513,3074,7942,19542
48,399,48399,Texas,Runnels County,4802,4733,151,114,83,63,1844,1728,9535,166,302,3572
48,401,48401,Texas,Rusk County,22694,20211,5501,4020,200,186,5430,4094,42905,400,11002,9524
48,403,48403,Texas,Sabine County,4609,4865,380,349,15,26,251,263,9474,30,760,514
48,405,48405,Texas,San Augustine County,3115,3117,815,939,11,18,345,291,6232,22,1630,636
48,407,48407,Texas,San Jacinto County,12477,12549,1346,1392,64,93,2014,1967,25026,128,2692,3981
48,409,48409,Texas,San Patricio County,31627,31134,761,627,359,453,19673,19355,62761,718,1522,39028
48,411,48411,Texas,San Saba County,2962,2608,206,36,14,25,1074,781,5570,28,412,1855
48,413,48413,Texas,Schleicher County,1320,1318,26,24,5,7,768,757,2638,10,52,1525
48,415,48415,Texas,Scurry County,7975,7123,680,235,80,53,3778,3045,15098,160,1360,6823
48,417,48417,Texas,Shackelford County,1511,1585,34,26,3,12,184,185,3096,6,68,369
48,419,48419,Texas,Shelby County,9905,9865,2083,2408,201,144,2559,2170,19770,402,4166,4729
48,421,48421,Texas,Sherman County,1480,1382,42,15,12,13,728,609,2862,24,84,1337
48,423,48423,Texas,Smith County,88124,92851,19213,22233,1772,2065,23725,23021,180975,3544,38426,46746
48,425,48425,Texas,Somervell County,4232,4323,68,48,42,54,835,818,8555,84,136,1653
48,427,48427,Texas,Starr County,31061,32677,145,117,77,80,30355,31921,63738,154,290,62276
48,429,48429,Texas,Stephens County,4548,4200,197,83,48,31,1240,1047,8748,96,394,2287
48,431,48431,Texas,Sterling County,608,598,19,8,3,2,267,260,1206,6,38,527
48,433,48433,Texas,Stonewall County,606,631,23,22,8,9,129,113,1237,16,46,242
48,435,48435,Texas,Sutton County,1856,1774,25,11,8,12,1262,1147,3630,16,50,2409
48,437,48437,Texas,Swisher County,3370,3039,424,214,15,36,1788,1548,6409,30,848,3336
48,439,48439,Texas,Tarrant County,754362,772436,176833,198719,58121,64028,311654,308056,1526798,116242,353666,619710
48,441,48441,Texas,Taylor County,57006,60567,5942,5604,1322,1895,16841,17630,117573,2644,11884,34471
48,443,48443,Texas,Terrell County,350,357,11,2,6,3,202,197,707,12,22,399
48,445,48445,Texas,Terry County,5907,5410,366,214,35,40,3660,3245,11317,70,732,6905
48,447,48447,Texas,Throckmorton County,694,745,6,8,2,6,92,123,1439,4,12,215
48,449,48449,Texas,Titus County,13632,14124,1520,1726,189,198,7287,7149,27756,378,3040,14436
48,451,48451,Texas,Tom Green County,53497,54516,2828,2388,815,884,24077,24457,108013,1630,5656,48534
48,453,48453,Texas,Travis County,514852,500598,56003,57255,47356,47172,218755,209816,1015450,94712,112006,428571
48,455,48455,Texas,Trinity County,6195,6651,621,690,30,46,771,793,12846,60,1242,1564
48,457,48457,Texas,Tyler County,9744,8848,1618,810,48,87,1362,428,18592,96,3236,1790
48,459,48459,Texas,Upshur County,18197,18663,1602,1708,98,120,1940,1847,36860,196,3204,3787
48,461,48461,Texas,Upton County,1684,1658,57,68,12,10,988,1000,3342,24,114,1988
48,463,48463,Texas,Uvalde County,12492,13055,196,147,102,129,9537,9908,25547,204,392,19445
48,465,48465,Texas,Val Verde County,23611,22769,584,440,212,212,20208,20131,46380,424,1168,40339
48,467,48467,Texas,Van Zandt County,25838,27150,848,809,147,178,3446,3153,52988,294,1696,6599
48,469,48469,Texas,Victoria County,40319,42057,3003,3044,581,726,21808,22244,82376,1162,6006,44052
48,471,48471,Texas,Walker County,30099,22962,10873,6333,441,392,7954,5241,53061,882,21746,13195
48,473,48473,Texas,Waller County,19756,19449,6453,7054,374,380,8863,8289,39205,748,12906,17152
48,475,48475,Texas,Ward County,5478,5347,331,304,33,38,3391,3227,10825,66,662,6618
48,477,48477,Texas,Washington County,13817,14374,3093,3232,277,353,3118,2890,28191,554,6186,6008
48,479,48479,Texas,Webb County,132579,137361,1179,854,845,859,129190,134708,269940,1690,2358,263898
48,481,48481,Texas,Wharton County,17160,17676,2721,2925,112,132,8881,8821,34836,224,5442,17702
48,483,48483,Texas,Wheeler County,2360,2310,86,71,12,32,672,601,4670,24,172,1273
48,485,48485,Texas,Wichita County,55964,53036,8103,6576,1328,1496,13943,12277,109000,2656,16206,26220
48,487,48487,Texas,Wilbarger County,5234,5555,549,502,220,180,1908,1898,10789,440,1098,3806
48,489,48489,Texas,Willacy County,11089,9210,441,143,139,46,10296,8612,20299,278,882,18908
48,491,48491,Texas,Williamson County,234536,241743,21459,22087,23288,24051,72546,74056,476279,46576,42918,146602
48,493,48493,Texas,Wilson County,24355,24153,532,422,123,211,10253,10269,48508,246,1064,20522
48,495,48495,Texas,Winkler County,3804,3594,168,106,38,34,2579,2375,7398,76,336,4954
48,497,48497,Texas,Wise County,33173,33158,656,456,222,241,7153,6812,66331,444,1312,13965
48,499,48499,Texas,Wood County,20509,20987,1344,1186,141,138,2468,2246,41496,282,2688,4714
48,501,48501,Texas,Yoakum County,4195,4065,69,64,26,27,3034,2849,8260,52,138,5883
48,503,48503,Texas,Young County,8444,8582,170,137,65,76,1877,1608,17026,130,340,3485
48,505,48505,Texas,Zapata County,6932,7018,49,29,14,21,6671,6758,13950,28,98,13429
48,507,48507,Texas,Zavala County,5800,5628,86,66,20,10,5673,5462,11428,40,172,11135
49,1,49001,Utah,Beaver County,3198,3127,9,15,26,29,436,397,6325,52,18,833
49,3,49003,Utah,Box Elder County,27154,26190,214,116,195,275,2870,2561,53344,390,428,5431
49,5,49005,Utah,Cache County,59507,59720,813,570,1483,1518,7076,6945,119227,2966,1626,14021
49,7,49007,Utah,Carbon County,9613,9794,65,61,69,65,1400,1346,19407,138,130,2746
49,9,49009,Utah,Daggett County,520,386,2,0,3,2,30,12,906,6,4,42
49,11,49011,Utah,Davis County,165324,162190,2934,2158,3274,4144,18448,17669,327514,6548,5868,36117
49,13,49013,Utah,Duchesne County,9159,8970,69,39,45,56,933,723,18129,90,138,1656
49,15,49015,Utah,Emery County,4915,4732,24,21,25,29,339,309,9647,50,48,648
49,17,49017,Utah,Garfield County,2471,2245,16,13,29,25,177,152,4716,58,32,329
49,19,49019,Utah,Grand County,4439,4389,59,30,56,93,515,517,8828,112,118,1032
49,21,49021,Utah,Iron County,25595,25631,226,166,243,280,2495,2404,51226,486,452,4899
49,23,49023,Utah,Juab County,5900,5628,43,28,23,28,347,351,11528,46,86,698
49,25,49025,Utah,Kane County,3734,3735,39,22,40,37,210,163,7469,80,78,373
49,27,49027,Utah,Millard County,6330,6045,55,20,101,106,923,773,12375,202,110,1696
49,29,49029,Utah,Morgan County,6058,5728,31,26,42,25,176,215,11786,84,62,391
49,31,49031,Utah,Piute County,727,697,2,2,3,3,60,59,1424,6,4,119
49,33,49033,Utah,Rich County,1247,1167,6,3,3,5,100,70,2414,6,12,170
49,35,49035,Utah,Salt Lake County,507167,503869,14493,11495,25408,27569,111452,106791,1011036,50816,28986,218243
49,37,49037,Utah,San Juan County,3701,3617,38,26,41,49,465,422,7318,82,76,887
49,39,49039,Utah,Sanpete County,15162,13907,258,98,114,143,1710,1233,29069,228,516,2943
49,41,49041,Utah,Sevier County,10576,10144,89,34,33,52,602,590,20720,66,178,1192
49,43,49043,Utah,Summit County,20419,19407,252,249,371,413,2427,2413,39826,742,504,4840
49,45,49045,Utah,Tooele County,34426,33562,383,262,266,323,4867,4488,67988,532,766,9355
49,47,49047,Utah,Uintah County,16022,15445,155,85,95,116,1644,1369,31467,190,310,3013
49,49,49049,Utah,Utah County,297866,291925,2914,2349,5500,6397,39524,37931,589791,11000,5828,77455
49,51,49051,Utah,Wasatch County,16538,15994,176,105,155,201,2430,2226,32532,310,352,4656
49,53,49053,Utah,Washington County,81946,83580,964,667,756,1080,9953,9365,165526,1512,1928,19318
49,55,49055,Utah,Wayne County,1321,1277,10,3,14,12,100,91,2598,28,20,191
49,57,49057,Utah,Weber County,120712,119284,2560,1975,1929,2310,25114,23643,239996,3858,5120,48757
50,1,50001,Vermont,Addison County,17357,17384,300,190,302,376,472,369,34741,604,600,841
50,3,50003,Vermont,Bennington County,16475,17398,276,208,178,221,367,423,33873,356,552,790
50,5,50005,Vermont,Caledonia County,14340,14476,170,97,131,149,263,233,28816,262,340,496
50,7,50007,Vermont,Chittenden County,72270,75619,2279,1897,3428,4029,1947,2082,147889,6856,4558,4029
50,9,50009,Vermont,Essex County,3003,2932,27,10,9,37,38,53,5935,18,54,91
50,11,50011,Vermont,Franklin County,23355,23560,211,159,195,217,431,415,46915,390,422,846
50,13,50013,Vermont,Grand Isle County,3439,3362,36,29,17,27,82,69,6801,34,72,151
50,15,50015,Vermont,Lamoille County,12144,12171,184,114,79,97,245,224,24315,158,368,469
50,17,50017,Vermont,Orange County,14042,13940,103,92,77,89,187,215,27982,154,206,402
50,19,50019,Vermont,Orleans County,13010,12979,133,94,51,71,245,207,25989,102,266,452
50,21,50021,Vermont,Rutland County,27798,28311,267,152,214,365,489,447,56109,428,534,936
50,23,50023,Vermont,Washington County,27797,28155,331,217,266,297,598,570,55952,532,662,1168
50,25,50025,Vermont,Windham County,19564,20421,395,253,178,330,547,483,39985,356,790,1030
50,27,50027,Vermont,Windsor County,25810,26990,323,227,226,308,525,493,52800,452,646,1018
51,1,51001,Virginia,Accomack County,10703,11196,4455,4849,106,151,1605,1350,21899,212,8910,2955
51,3,51003,Virginia,Albemarle County,42775,46613,5043,5557,2919,3132,3173,3140,89388,5838,10086,6313
51,5,51005,Virginia,Alleghany County,6689,7094,384,314,22,24,117,121,13783,44,768,238
51,7,51007,Virginia,Amelia County,5026,5024,1252,1436,29,51,227,191,10050,58,2504,418
51,9,51009,Virginia,Amherst County,11746,12553,3017,3024,80,100,403,364,24299,160,6034,767
51,11,51011,Virginia,Appomattox County,6107,6414,1389,1562,23,38,161,139,12521,46,2778,300
51,13,51013,Virginia,Arlington County,90466,87173,11263,11659,11767,14178,18985,17966,177639,23534,22526,36951
51,15,51015,Virginia,Augusta County,34986,35116,2400,1118,220,270,1285,1089,70102,440,4800,2374
51,17,51017,Virginia,Bath County,1955,1898,112,89,6,14,39,52,3853,12,224,91
51,19,51019,Virginia,Bedford County,34822,35928,2825,2872,430,545,944,926,70750,860,5650,1870
51,21,51021,Virginia,Bland County,3180,2739,204,46,19,17,40,22,5919,38,408,62
51,23,51023,Virginia,Botetourt County,15586,15870,596,497,93,169,302,284,31456,186,1192,586
51,25,51025,Virginia,Brunswick County,3520,3361,4934,3956,95,56,236,162,6881,190,9868,398
51,27,51027,Virginia,Buchanan County,9920,10093,578,132,39,54,85,102,20013,78,1156,187
51,29,51029,Virginia,Buckingham County,5788,5062,3376,2407,39,35,245,170,10850,78,6752,415
51,31,51031,Virginia,Campbell County,21704,23031,4022,4101,249,343,829,737,44735,498,8044,1566
51,33,51033,Virginia,Caroline County,10200,10439,4200,4149,160,187,827,784,20639,320,8400,1611
51,35,51035,Virginia,Carroll County,14349,14615,140,123,25,43,657,490,28964,50,280,1147
51,36,51036,Virginia,Charles City County,1577,1539,1452,1641,15,29,64,62,3116,30,2904,126
51,37,51037,Virginia,Charlotte County,4170,4132,1566,1715,11,23,185,90,8302,22,3132,275
51,41,51041,Virginia,Chesterfield County,117490,123067,39968,46593,6210,6749,17092,16290,240557,12420,79936,33382
51,43,51043,Virginia,Clarke County,6571,6680,323,358,94,116,509,423,13251,188,646,932
51,45,51045,Virginia,Craig County,2503,2529,16,7,2,6,44,37,5032,4,32,81
51,47,51047,Virginia,Culpeper County,20618,21171,4048,3624,452,440,3174,2924,41789,904,8096,6098
51,49,51049,Virginia,Cumberland County,3215,3325,1408,1621,17,29,182,138,6540,34,2816,320
51,51,51051,Virginia,Dickenson County,7164,6899,38,38,14,18,79,72,14063,28,76,151
51,53,51053,Virginia,Dinwiddie County,9258,9232,4365,4831,76,164,564,513,18490,152,8730,1077
51,57,51057,Virginia,Essex County,2988,3285,1881,2219,42,85,236,191,6273,84,3762,427
51,59,51059,Virginia,Fairfax County,373263,368915,59626,62328,110349,120736,95848,93667,742178,220698,119252,189515
51,61,51061,Virginia,Fauquier County,30688,31293,2776,2798,537,693,3279,3243,61981,1074,5552,6522
51,63,51063,Virginia,Floyd County,7578,7468,165,154,42,42,252,222,15046,84,330,474
51,65,51065,Virginia,Fluvanna County,10251,11752,1727,2433,98,159,505,543,22003,196,3454,1048
51,67,51067,Virginia,Franklin County,24612,25590,2246,2184,113,150,816,797,50202,226,4492,1613
51,69,51069,Virginia,Frederick County,40108,40759,2332,1893,688,885,4345,3980,80867,1376,4664,8325
51,71,51071,Virginia,Giles County,7944,8153,142,125,46,51,158,149,16097,92,284,307
51,73,51073,Virginia,Gloucester County,16155,16644,1473,1510,134,199,693,718,32799,268,2946,1411
51,75,51075,Virginia,Goochland County,9314,9792,1906,1837,198,211,339,396,19106,396,3812,735
51,77,51077,Virginia,Grayson County,7163,7218,694,199,9,23,332,263,14381,18,1388,595
51,79,51079,Virginia,Greene County,8435,8923,750,700,167,227,591,605,17358,334,1500,1196
51,81,51081,Virginia,Greensville County,2643,1638,4363,2460,33,46,194,122,4281,66,8726,316
51,83,51083,Virginia,Halifax County,10093,10653,5740,6565,103,134,411,335,20746,206,11480,746
51,85,51085,Virginia,Hanover County,45537,47096,4993,5271,899,1195,1762,1585,92633,1798,9986,3347
51,87,51087,Virginia,Henrico County,91283,97334,45813,56322,15089,15063,10358,9376,188617,30178,91626,19734
51,89,51089,Virginia,Henry County,18133,19492,5429,6005,123,131,1510,1416,37625,246,10858,2926
51,91,51091,Virginia,Highland County,1053,1085,15,9,7,7,16,7,2138,14,30,23
51,93,51093,Virginia,Isle of Wight County,13408,13573,4068,4549,147,216,649,609,26981,294,8136,1258
51,95,51095,Virginia,James City County,29791,31682,4995,5438,872,1151,2372,2320,61473,1744,9990,4692
51,97,51097,Virginia,King and Queen County,2505,2339,902,938,13,22,135,85,4844,26,1804,220
51,99,51099,Virginia,King George County,10626,10274,2145,2166,197,235,827,741,20900,394,4290,1568
51,101,51101,Virginia,King William County,6717,6891,1221,1424,86,107,268,223,13608,172,2442,491
51,103,51103,Virginia,Lancaster County,3461,3854,1407,1604,37,46,157,112,7315,74,2814,269
51,105,51105,Virginia,Lee County,11167,10973,793,79,42,29,359,102,22140,84,1586,461
51,107,51107,Virginia,Loudoun County,138227,139025,16758,16707,41000,43135,28785,28723,277252,82000,33516,57508
51,109,51109,Virginia,Louisa County,15063,15315,2858,2988,103,140,674,577,30378,206,5716,1251
51,111,51111,Virginia,Lunenburg County,3964,3708,2293,1837,20,22,391,266,7672,40,4586,657
51,113,51113,Virginia,Madison County,5566,5955,641,588,34,49,201,227,11521,68,1282,428
51,115,51115,Virginia,Mathews County,3777,4006,359,388,28,49,142,98,7783,56,718,240
51,117,51117,Virginia,Mecklenburg County,9320,9720,5096,5474,120,137,568,387,19040,240,10192,955
51,119,51119,Virginia,Middlesex County,4088,4387,913,846,23,28,158,150,8475,46,1826,308
51,121,51121,Virginia,Montgomery County,43538,41669,2313,1925,3496,2749,1869,1555,85207,6992,4626,3424
51,125,51125,Virginia,Nelson County,6185,6500,774,927,40,73,356,286,12685,80,1548,642
51,127,51127,Virginia,New Kent County,9407,9255,1752,1448,116,166,494,344,18662,232,3504,838
51,131,51131,Virginia,Northampton County,3641,3700,1735,2217,60,62,648,460,7341,120,3470,1108
51,133,51133,Virginia,Northumberland County,4376,4381,1420,1602,22,40,246,217,8757,44,2840,463
51,135,51135,Virginia,Nottoway County,4567,4196,3446,2544,46,39,416,313,8763,92,6892,729
51,137,51137,Virginia,Orange County,14899,15574,2458,2454,165,234,1122,935,30473,330,4916,2057
51,139,51139,Virginia,Page County,11266,11566,301,231,53,68,274,253,22832,106,602,527
51,141,51141,Virginia,Patrick County,8050,8235,495,432,22,37,295,263,16285,44,990,558
51,143,51143,Virginia,Pittsylvania County,22754,23236,6259,6711,129,174,951,712,45990,258,12518,1663
51,145,51145,Virginia,Powhatan County,13223,12873,1710,1016,69,109,364,323,26096,138,3420,687
51,147,51147,Virginia,Prince Edward County,7346,7101,3666,3822,125,193,397,277,14447,250,7332,674
51,149,51149,Virginia,Prince George County,12152,10969,7103,5407,344,493,1871,1445,23121,688,14206,3316
51,153,51153,Virginia,Prince William County,148680,144718,51416,53096,20951,23478,59645,55528,293398,41902,102832,115173
51,155,51155,Virginia,Pulaski County,15652,15748,945,773,113,114,340,279,31400,226,1890,619
51,157,51157,Virginia,Rappahannock County,3347,3460,157,152,34,37,144,179,6807,68,314,323
51,159,51159,Virginia,Richmond County,3138,2885,1785,890,37,27,415,243,6023,74,3570,658
51,161,51161,Virginia,Roanoke County,39790,43008,3026,3006,1525,1757,1556,1558,82798,3050,6052,3114
51,163,51163,Virginia,Rockbridge County,10445,10672,399,347,64,104,238,222,21117,128,798,460
51,165,51165,Virginia,Rockingham County,37725,39458,1170,912,366,434,3188,2912,77183,732,2340,6100
51,167,51167,Virginia,Russell County,12634,13308,171,114,35,29,201,172,25942,70,342,373
51,169,51169,Virginia,Scott County,10559,10481,126,71,16,25,163,154,21040,32,252,317
51,171,51171,Virginia,Shenandoah County,19987,20834,670,599,196,288,1712,1495,40821,392,1340,3207
51,173,51173,Virginia,Smyth County,14050,14753,402,346,85,68,301,304,28803,170,804,605
51,175,51175,Virginia,Southampton County,5669,5313,3186,2939,37,53,169,190,10982,74,6372,359
51,177,51177,Virginia,Spotsylvania County,50716,52043,11770,12027,1643,2216,7431,7172,102759,3286,23540,14603
51,179,51179,Virginia,Stafford County,55339,53091,15296,15290,2358,3135,11098,10575,108430,4716,30592,21673
51,181,51181,Virginia,Surry County,1830,1714,1248,1420,15,17,87,88,3544,30,2496,175
51,183,51183,Virginia,Sussex County,2565,2042,3929,2334,27,24,205,162,4607,54,7858,367
51,185,51185,Virginia,Tazewell County,18807,19663,908,402,120,144,275,186,38470,240,1816,461
51,187,51187,Virginia,Warren County,18082,18253,1044,949,213,319,1074,1051,36335,426,2088,2125
51,191,51191,Virginia,Washington County,25565,26415,496,320,121,170,507,370,51980,242,992,877
51,193,51193,Virginia,Westmoreland County,6103,6366,2262,2442,58,103,759,480,12469,116,4524,1239
51,195,51195,Virginia,Wise County,17253,17309,1885,277,77,81,272,190,34562,154,3770,462
51,197,51197,Virginia,Wythe County,13224,13900,451,402,77,89,217,182,27124,154,902,399
51,199,51199,Virginia,York County,25656,25809,4509,4933,1767,2380,2352,2349,51465,3534,9018,4701
51,510,51510,Virginia,Alexandria city,51830,54499,17559,18731,4400,5978,13356,13123,106329,8800,35118,26479
51,520,51520,Virginia,Bristol city,7065,7993,542,509,66,88,212,205,15058,132,1084,417
51,530,51530,Virginia,Buena Vista city,2697,3159,190,144,21,22,77,103,5856,42,380,180
51,540,51540,Virginia,Charlottesville city,16358,17077,4064,4629,1623,1784,1488,1257,33435,3246,8128,2745
51,550,51550,Virginia,Chesapeake city,75146,75682,35510,39440,3861,4701,8210,8029,150828,7722,71020,16239
51,570,51570,Virginia,Colonial Heights city,6052,7086,1343,1557,256,407,553,585,13138,512,2686,1138
51,580,51580,Virginia,Covington city,2158,2401,402,359,20,33,71,52,4559,40,804,123
51,590,51590,Virginia,Danville city,8466,9510,9191,11442,280,272,1040,842,17976,560,18382,1882
51,595,51595,Virginia,Emporia city,799,883,1587,1898,24,30,191,155,1682,48,3174,346
51,600,51600,Virginia,Fairfax city,8305,8579,785,737,2148,2383,2158,2074,16884,4296,1570,4232
51,610,51610,Virginia,Falls Church city,5776,5895,368,340,635,820,794,760,11671,1270,736,1554
51,620,51620,Virginia,Franklin city,1457,1640,2036,2544,33,44,113,101,3097,66,4072,214
51,630,51630,Virginia,Fredericksburg city,9106,10506,3211,3792,359,535,1619,1553,19612,718,6422,3172
51,640,51640,Virginia,Galax city,2606,3037,227,217,23,26,496,538,5643,46,454,1034
51,650,51650,Virginia,Hampton city,28048,27430,31760,37216,1423,1859,4173,4195,55478,2846,63520,8368
51,660,51660,Virginia,Harrisonburg city,20822,22960,2453,2266,1182,1156,5599,5399,43782,2364,4906,10998
51,670,51670,Virginia,Hopewell city,5488,5869,4383,5413,132,214,963,951,11357,264,8766,1914
51,678,51678,Virginia,Lexington city,3552,2791,361,279,129,92,162,105,6343,258,722,267
51,680,51680,Virginia,Lynchburg city,25727,28738,10638,12408,1049,1165,1756,1948,54465,2098,21276,3704
51,683,51683,Virginia,Manassas city,15164,14851,3132,3195,1241,1363,8169,7487,30015,2482,6264,15656
51,685,51685,Virginia,Manassas Park city,6111,5671,1403,1327,954,1059,3863,3311,11782,1908,2806,7174
51,690,51690,Virginia,Martinsville city,2818,3258,2764,3193,81,72,432,378,6076,162,5528,810
51,700,51700,Virginia,Newport News city,43750,43449,35543,41195,2601,3322,8697,8181,87199,5202,71086,16878
51,710,51710,Virginia,Norfolk city,66717,53023,49114,53058,4660,4673,11812,8723,119740,9320,98228,20535
51,720,51720,Virginia,Norton city,1657,1914,112,123,46,26,103,50,3571,92,224,153
51,730,51730,Virginia,Petersburg city,2770,2980,10840,13288,178,183,825,785,5750,356,21680,1610
51,735,51735,Virginia,Poquoson city,5728,5713,81,70,122,174,227,182,11441,244,162,409
51,740,51740,Virginia,Portsmouth city,19243,18695,23531,27910,689,718,2319,2119,37938,1378,47062,4438
51,750,51750,Virginia,Radford city,7410,8242,776,926,154,225,222,328,15652,308,1552,550
51,760,51760,Virginia,Richmond city,54500,55458,48819,59238,2495,2866,8965,7840,109958,4990,97638,16805
51,770,51770,Virginia,Roanoke city,29923,32780,13711,15494,1870,1659,3565,3075,62703,3740,27422,6640
51,775,51775,Virginia,Salem city,10572,11618,967,998,187,288,450,453,22190,374,1934,903
51,790,51790,Virginia,Staunton city,9519,11294,1358,1491,141,199,410,415,20813,282,2716,825
51,800,51800,Virginia,Suffolk city,24088,23905,18271,20975,794,960,2239,2061,47993,1588,36542,4300
51,810,51810,Virginia,Virginia Beach city,150591,152591,43770,47391,15365,17876,19188,19047,303182,30730,87540,38235
51,820,51820,Virginia,Waynesboro city,8778,9487,1437,1603,186,196,984,982,18265,372,2874,1966
51,830,51830,Virginia,Williamsburg city,5120,5893,1079,1312,397,507,537,532,11013,794,2158,1069
51,840,51840,Virginia,Winchester city,11167,11695,1632,1542,371,393,2699,2428,22862,742,3264,5127
53,1,53001,Washington,Adams County,9010,8672,254,183,117,153,6673,6263,17682,234,508,12936
53,3,53003,Washington,Asotin County,10296,10757,102,76,98,123,469,520,21053,196,204,989
53,5,53005,Washington,Benton County,92162,91839,1984,1721,3259,3506,23408,22802,184001,6518,3968,46210
53,7,53007,Washington,Chelan County,36001,35951,394,298,404,538,11477,10328,71952,808,788,21805
53,9,53009,Washington,Clallam County,33135,34217,661,237,554,900,2659,2417,67352,1108,1322,5076
53,11,53011,Washington,Clark County,208218,212343,6355,5294,11034,13553,25342,24414,420561,22068,12710,49756
53,13,53013,Washington,Columbia County,1813,1818,17,10,17,40,151,164,3631,34,34,315
53,15,53015,Washington,Cowlitz County,49793,50909,745,523,719,1033,5216,5109,100702,1438,1490,10325
53,17,53017,Washington,Douglas County,20370,19963,201,151,223,271,7404,6632,40333,446,402,14036
53,19,53019,Washington,Ferry County,2989,2818,42,20,41,45,200,168,5807,82,84,368
53,21,53021,Washington,Franklin County,43993,41608,1656,1049,1099,1214,26066,24935,85601,2198,3312,51001
53,23,53023,Washington,Garfield County,1026,1038,3,0,17,55,67,57,2064,34,6,124
53,25,53025,Washington,Grant County,45666,44360,1008,774,568,578,21449,19787,90026,1136,2016,41236
53,27,53027,Washington,Grays Harbor County,33223,32119,778,286,519,598,4090,3655,65342,1038,1556,7745
53,29,53029,Washington,Island County,36308,36255,1668,1091,1693,2657,3480,3490,72563,3386,3336,6970
53,31,53031,Washington,Jefferson County,14341,15017,251,97,228,414,634,588,29358,456,502,1222
53,33,53033,Washington,King County,755541,735602,81928,76830,215811,228867,115691,106951,1491143,431622,163856,222642
53,35,53035,Washington,Kitsap County,115096,108768,5239,3438,6181,8446,11896,10481,223864,12362,10478,22377
53,37,53037,Washington,Kittitas County,22093,21796,315,255,532,541,2133,2186,43889,1064,630,4319
53,39,53039,Washington,Klickitat County,10493,10311,92,61,83,126,1404,1225,20804,166,184,2629
53,41,53041,Washington,Lewis County,37059,37167,479,276,468,599,4494,4006,74226,936,958,8500
53,43,53043,Washington,Lincoln County,5230,5035,38,31,21,37,197,196,10265,42,76,393
53,45,53045,Washington,Mason County,30220,28223,741,262,302,552,4003,3096,58443,604,1482,7099
53,47,53047,Washington,Okanogan County,17409,16897,218,173,181,355,4744,4009,34306,362,436,8753
53,49,53049,Washington,Pacific County,9979,10244,146,108,244,238,1184,1096,20223,488,292,2280
53,51,53051,Washington,Pend Oreille County,6403,6103,57,39,53,112,298,260,12506,106,114,558
53,53,53053,Washington,Pierce County,336773,336015,37708,32053,28071,35785,53201,49826,672788,56142,75416,103027
53,55,53055,Washington,San Juan County,7982,8532,75,59,97,166,594,598,16514,194,150,1192
53,57,53057,Washington,Skagit County,57636,59049,868,583,1390,1637,12309,11741,116685,2780,1736,24050
53,59,53059,Washington,Skamania County,5719,5499,53,27,51,79,409,416,11218,102,106,825
53,61,53061,Washington,Snohomish County,318547,314165,17506,13771,46649,52397,45319,41848,632712,93298,35012,87167
53,63,53063,Washington,Spokane County,230272,234726,6085,4398,5689,7053,16381,15454,464998,11378,12170,31835
53,65,53065,Washington,Stevens County,20417,20354,156,104,142,237,901,859,40771,284,312,1760
53,67,53067,Washington,Thurston County,115633,121196,5852,4591,8080,10181,13685,13527,236829,16160,11704,27212
53,69,53069,Washington,Wahkiakum County,2053,2038,19,13,31,49,121,137,4091,62,38,258
53,71,53071,Washington,Walla Walla County,28019,27489,1019,345,423,640,6779,6387,55508,846,2038,13166
53,73,53073,Washington,Whatcom County,97636,100079,1683,1210,4975,5953,11548,10941,197715,9950,3366,22489
53,75,53075,Washington,Whitman County,21352,20657,678,513,2125,2067,1659,1601,42009,4250,1356,3260
53,77,53077,Washington,Yakima County,108872,109289,2153,1747,1877,2125,63997,61819,218161,3754,4306,125816
54,1,54001,West Virginia,Barbour County,7721,8140,92,74,18,32,105,78,15861,36,184,183
54,3,54003,West Virginia,Berkeley County,51812,52676,4890,4510,529,799,3015,2708,104488,1058,9780,5723
54,5,54005,West Virginia,Boone County,10463,10602,99,60,14,13,78,61,21065,28,198,139
54,7,54007,West Virginia,Braxton County,6823,6761,74,25,13,20,76,51,13584,26,148,127
54,9,54009,West Virginia,Brooke County,10394,10741,201,124,45,65,106,91,21135,90,402,197
54,11,54011,West Virginia,Cabell County,40855,43068,2261,2174,590,571,692,608,83923,1180,4522,1300
54,13,54013,West Virginia,Calhoun County,3486,3480,19,8,4,8,45,35,6966,8,38,80
54,15,54015,West Virginia,Clay County,4220,4126,14,12,3,5,50,30,8346,6,28,80
54,17,54017,West Virginia,Doddridge County,4443,3628,164,25,9,19,29,27,8071,18,328,56
54,19,54019,West Virginia,Fayette County,19840,19757,1028,850,44,78,283,233,39597,88,2056,516
54,21,54021,West Virginia,Gilmer County,3647,3060,810,36,34,26,376,55,6707,68,1620,431
54,23,54023,West Virginia,Grant County,5598,5662,83,56,13,12,88,75,11260,26,166,163
54,25,54025,West Virginia,Greenbrier County,15945,16758,526,421,92,113,405,322,32703,184,1052,727
54,27,54027,West Virginia,Hampshire County,11396,11044,193,123,34,36,186,163,22440,68,386,349
54,29,54029,West Virginia,Hancock County,13285,14057,434,348,70,72,252,209,27342,140,868,461
54,31,54031,West Virginia,Hardy County,6494,6473,267,168,50,47,394,281,12967,100,534,675
54,33,54033,West Virginia,Harrison County,31475,32746,725,536,193,243,592,574,64221,386,1450,1166
54,35,54035,West Virginia,Jackson County,13849,14061,104,70,42,55,150,138,27910,84,208,288
54,37,54037,West Virginia,Jefferson County,25139,25583,1891,1779,370,526,1868,1719,50722,740,3782,3587
54,39,54039,West Virginia,Kanawha County,75762,82266,6763,6703,924,963,1027,1056,158028,1848,13526,2083
54,41,54041,West Virginia,Lewis County,7690,7761,69,39,34,56,109,89,15451,68,138,198
54,43,54043,West Virginia,Lincoln County,9920,10117,53,32,17,25,80,70,20037,34,106,150
54,45,54045,West Virginia,Logan County,15279,15706,295,295,38,46,166,156,30985,76,590,322
54,47,54047,West Virginia,McDowell County,7796,8067,675,766,10,18,182,64,15863,20,1350,246
54,49,54049,West Virginia,Marion County,25958,26748,1016,817,164,185,416,346,52706,328,2032,762
54,51,54051,West Virginia,Marshall County,14751,14994,147,91,51,61,138,162,29745,102,294,300
54,53,54053,West Virginia,Mason County,12464,13325,114,128,32,44,119,94,25789,64,228,213
54,55,54055,West Virginia,Mercer County,25674,27930,1728,1821,158,187,409,320,53604,316,3456,729
54,57,54057,West Virginia,Mineral County,12662,12749,408,385,65,104,127,140,25411,130,816,267
54,59,54059,West Virginia,Mingo County,11138,11431,237,228,34,33,119,82,22569,68,474,201
54,61,54061,West Virginia,Monongalia County,48387,46878,2552,1551,1891,1654,1259,1093,95265,3782,5104,2352
54,63,54063,West Virginia,Monroe County,6422,6456,58,48,9,15,67,64,12878,18,116,131
54,65,54065,West Virginia,Morgan County,8646,8608,113,53,27,47,131,166,17254,54,226,297
54,67,54067,West Virginia,Nicholas County,11789,12083,48,105,44,46,100,93,23872,88,96,193
54,69,54069,West Virginia,Ohio County,18547,19970,815,702,148,187,297,240,38517,296,1630,537
54,71,54071,West Virginia,Pendleton County,3360,3321,77,71,6,7,48,56,6681,12,154,104
54,73,54073,West Virginia,Pleasants County,3854,3340,112,12,11,5,35,34,7194,22,224,69
54,75,54075,West Virginia,Pocahontas County,4073,3897,64,48,9,8,67,72,7970,18,128,139
54,77,54077,West Virginia,Preston County,16644,15922,266,117,28,48,307,227,32566,56,532,534
54,79,54079,West Virginia,Putnam County,26794,27558,356,332,211,257,376,333,54352,422,712,709
54,81,54081,West Virginia,Raleigh County,32144,33020,3475,2387,298,329,811,429,65164,596,6950,1240
54,83,54083,West Virginia,Randolph County,14281,13385,367,99,47,90,151,154,27666,94,734,305
54,85,54085,West Virginia,Ritchie County,4667,4704,31,15,7,15,40,43,9371,14,62,83
54,87,54087,West Virginia,Roane County,6608,6776,18,24,22,26,87,86,13384,44,36,173
54,89,54089,West Virginia,Summers County,5473,6245,122,425,16,26,69,156,11718,32,244,225
54,91,54091,West Virginia,Taylor County,8183,7998,129,68,25,52,90,82,16181,50,258,172
54,93,54093,West Virginia,Tucker County,3391,3310,20,8,13,9,31,30,6701,26,40,61
54,95,54095,West Virginia,Tyler County,4229,4166,22,7,16,29,35,31,8395,32,44,66
54,97,54097,West Virginia,Upshur County,11591,11830,150,111,61,60,187,159,23421,122,300,346
54,99,54099,West Virginia,Wayne County,18788,19687,141,86,50,79,127,134,38475,100,282,261
54,101,54101,West Virginia,Webster County,3966,3969,27,10,3,13,26,34,7935,6,54,60
54,103,54103,West Virginia,Wetzel County,7181,7552,51,25,22,30,97,69,14733,44,102,166
54,105,54105,West Virginia,Wirt County,2894,2792,14,12,7,10,28,23,5686,14,28,51
54,107,54107,West Virginia,Wood County,38929,41403,580,454,224,274,526,492,80332,448,1160,1018
54,109,54109,West Virginia,Wyoming County,9827,10088,84,64,15,21,73,78,19915,30,168,151
55,1,55001,Wisconsin,Adams County,9913,9052,510,85,52,75,541,304,18965,104,1020,845
55,3,55003,Wisconsin,Ashland County,6542,6500,44,39,41,51,213,259,13042,82,88,472
55,5,55005,Wisconsin,Barron County,21477,21619,473,238,119,186,607,568,43096,238,946,1175
55,7,55007,Wisconsin,Bayfield County,6549,6286,53,41,25,54,170,168,12835,50,106,338
55,9,55009,Wisconsin,Brown County,114772,117477,4580,3294,4380,4677,12318,11588,232249,8760,9160,23906
55,11,55011,Wisconsin,Buffalo County,6458,6224,53,25,25,35,169,134,12682,50,106,303
55,13,55013,Wisconsin,Burnett County,7183,6918,60,65,27,46,175,133,14101,54,120,308
55,15,55015,Wisconsin,Calumet County,23933,23492,242,183,561,649,1195,1083,47425,1122,484,2278
55,17,55017,Wisconsin,Chippewa County,31467,29787,978,168,466,488,669,530,61254,932,1956,1199
55,19,55019,Wisconsin,Clark County,17089,16680,125,83,64,113,969,827,33769,128,250,1796
55,21,55021,Wisconsin,Columbia County,27794,27057,737,261,184,260,1180,921,54851,368,1474,2101
55,23,55023,Wisconsin,Crawford County,7885,7517,302,59,41,63,167,118,15402,82,604,285
55,25,55025,Wisconsin,Dane County,230114,234134,15329,14914,17158,17275,18642,17121,464248,34316,30658,35763
55,27,55027,Wisconsin,Dodge County,42665,40105,2568,371,268,305,2465,1970,82770,536,5136,4435
55,29,55029,Wisconsin,Door County,13152,13512,124,96,70,82,488,470,26664,140,248,958
55,31,55031,Wisconsin,Douglas County,19948,20015,337,204,222,263,379,351,39963,444,674,730
55,33,55033,Wisconsin,Dunn County,21367,21334,231,171,669,670,502,431,42701,1338,462,933
55,35,55035,Wisconsin,Eau Claire County,47308,48657,792,491,2205,2275,1494,1287,95965,4410,1584,2781
55,37,55037,Wisconsin,Florence County,2133,2006,10,9,6,12,20,24,4139,12,20,44
55,39,55039,Wisconsin,Fond du Lac County,47939,49073,1025,1268,869,1046,2934,2654,97012,1738,2050,5588
55,41,55041,Wisconsin,Forest County,3611,3547,79,41,13,18,125,113,7158,26,158,238
55,43,55043,Wisconsin,Grant County,25552,24038,603,184,225,262,559,374,49590,450,1206,933
55,45,55045,Wisconsin,Green County,17792,18000,176,116,105,143,553,605,35792,210,352,1158
55,47,55047,Wisconsin,Green Lake County,9154,9074,118,89,72,69,478,501,18228,144,236,979
55,49,55049,Wisconsin,Iowa County,11555,11370,101,81,89,102,249,227,22925,178,202,476
55,51,55051,Wisconsin,Iron County,2756,2704,9,8,9,12,43,36,5460,18,18,79
55,53,55053,Wisconsin,Jackson County,9678,8587,402,49,33,64,440,315,18265,66,804,755
55,55,55055,Wisconsin,Jefferson County,40674,40680,543,436,374,442,3197,3028,81354,748,1086,6225
55,57,55057,Wisconsin,Juneau County,13127,11932,608,63,57,107,504,343,25059,114,1216,847
55,59,55059,Wisconsin,Kenosha County,73341,74518,6202,6368,1328,1657,11445,11372,147859,2656,12404,22817
55,61,55061,Wisconsin,Kewaunee County,10110,9764,80,44,32,61,395,297,19874,64,160,692
55,63,55063,Wisconsin,La Crosse County,52317,55393,1078,828,2745,2810,1268,1205,107710,5490,2156,2473
55,65,55065,Wisconsin,Lafayette County,8216,8025,46,37,37,48,406,316,16241,74,92,722
55,67,55067,Wisconsin,Langlade County,9186,9081,130,102,44,52,209,198,18267,88,260,407
55,69,55069,Wisconsin,Lincoln County,13433,13216,202,52,72,89,246,220,26649,144,404,466
55,71,55071,Wisconsin,Manitowoc County,36884,37059,527,397,1120,1158,1883,1615,73943,2240,1054,3498
55,73,55073,Wisconsin,Marathon County,61669,61510,755,478,4167,4043,2103,1949,123179,8334,1510,4052
55,75,55075,Wisconsin,Marinette County,19599,19378,144,133,89,127,375,423,38977,178,288,798
55,77,55077,Wisconsin,Marquette County,7637,7363,62,44,46,65,319,258,15000,92,124,577
55,78,55078,Wisconsin,Menominee County,266,296,14,31,47,32,178,127,562,94,28,305
55,79,55079,Wisconsin,Milwaukee County,299485,307870,118845,138771,21791,22298,75048,72563,607355,43582,237690,147611
55,81,55081,Wisconsin,Monroe County,22051,21408,486,363,179,243,1204,1061,43459,358,972,2265
55,83,55083,Wisconsin,Oconto County,18729,17711,130,60,83,109,380,346,36440,166,260,726
55,85,55085,Wisconsin,Oneida County,17052,17057,164,76,90,124,300,290,34109,180,328,590
55,87,55087,Wisconsin,Outagamie County,85123,85834,1654,1206,3476,3435,4497,4074,170957,6952,3308,8571
55,89,55089,Wisconsin,Ozaukee County,41080,42600,866,684,1103,1208,1452,1337,83680,2206,1732,2789
55,91,55091,Wisconsin,Pepin County,3605,3516,25,13,8,20,90,69,7121,16,50,159
55,93,55093,Wisconsin,Pierce County,20346,20582,211,184,219,284,528,468,40928,438,422,996
55,95,55095,Wisconsin,Polk County,21275,20919,111,88,91,186,440,405,42194,182,222,845
55,97,55097,Wisconsin,Portage County,33420,32979,408,296,1153,1065,1236,1165,66399,2306,816,2401
55,99,55099,Wisconsin,Price County,6483,6230,58,39,43,53,116,140,12713,86,116,256
55,101,55101,Wisconsin,Racine County,81094,82506,11856,11683,1184,1416,13531,13223,163600,2368,23712,26754
55,103,55103,Wisconsin,Richland County,8387,8283,92,64,68,74,232,203,16670,136,184,435
55,105,55105,Wisconsin,Rock County,72570,74963,4398,4192,921,1260,7750,7186,147533,1842,8796,14936
55,107,55107,Wisconsin,Rusk County,6908,6721,108,79,22,27,148,132,13629,44,216,280
55,109,55109,Wisconsin,St. Croix County,43456,43479,492,281,401,623,1253,1124,86935,802,984,2377
55,111,55111,Wisconsin,Sauk County,30489,30774,473,384,208,266,1828,1647,61263,416,946,3475
55,113,55113,Wisconsin,Sawyer County,6660,6281,82,29,35,26,253,229,12941,70,164,482
55,115,55115,Wisconsin,Shawano County,18193,17811,145,107,102,102,607,586,36004,204,290,1193
55,117,55117,Wisconsin,Sheboygan County,51697,51594,1717,919,3352,3305,3991,3724,103291,6704,3434,7715
55,119,55119,Wisconsin,Taylor County,10069,9729,61,43,39,75,260,225,19798,78,122,485
55,121,55121,Wisconsin,Trempealeau County,14482,14060,98,79,85,118,1382,1277,28542,170,196,2659
55,123,55123,Wisconsin,Vernon County,15199,14925,86,57,56,72,239,251,30124,112,172,490
55,125,55125,Wisconsin,Vilas County,9736,9458,53,43,67,76,300,320,19194,134,106,620
55,127,55127,Wisconsin,Walworth County,49661,49826,704,586,539,581,6167,5470,99487,1078,1408,11637
55,129,55129,Wisconsin,Washburn County,7435,7559,33,29,47,58,167,140,14994,94,66,307
55,131,55131,Wisconsin,Washington County,64601,65262,922,921,928,1069,2317,2185,129863,1856,1844,4502
55,133,55133,Wisconsin,Waukesha County,183736,190034,3732,3359,7511,8025,10013,9840,373770,15022,7464,19853
55,135,55135,Wisconsin,Waupaca County,25022,24359,195,80,115,184,877,800,49381,230,390,1677
55,137,55137,Wisconsin,Waushara County,12069,11195,469,52,46,87,752,822,23264,92,938,1574
55,139,55139,Wisconsin,Winnebago County,78726,79070,2795,1507,2514,2744,3804,3686,157796,5028,5590,7490
55,141,55141,Wisconsin,Wood County,34021,35101,383,319,692,756,1194,1129,69122,1384,766,2323
56,1,56001,Wyoming,Albany County,18156,16935,498,261,749,767,1939,1818,35091,1498,996,3757
56,3,56003,Wyoming,Big Horn County,5665,5606,39,52,29,26,550,535,11271,58,78,1085
56,5,56005,Wyoming,Campbell County,22556,21311,175,131,180,193,2214,1903,43867,360,350,4117
56,7,56007,Wyoming,Carbon County,7354,6545,131,50,67,83,1502,1240,13899,134,262,2742
56,9,56009,Wyoming,Converse County,6747,6483,52,40,34,39,638,525,13230,68,104,1163
56,11,56011,Wyoming,Crook County,3661,3638,86,20,10,8,73,113,7299,20,172,186
56,13,56013,Wyoming,Fremont County,14631,14311,148,96,84,119,1474,1275,28942,168,296,2749
56,15,56015,Wyoming,Goshen County,6514,6002,108,41,94,57,817,614,12516,188,216,1431
56,17,56017,Wyoming,Hot Springs County,2107,2077,16,15,9,16,94,103,4184,18,32,197
56,19,56019,Wyoming,Johnson County,4081,3955,25,40,15,44,228,195,8036,30,50,423
56,21,56021,Wyoming,Laramie County,46091,45301,1518,992,649,703,7627,7216,91392,1298,3036,14843
56,23,56023,Wyoming,Lincoln County,9736,9341,62,50,38,73,477,432,19077,76,124,909
56,25,56025,Wyoming,Natrona County,37773,37078,577,569,301,397,3687,3282,74851,602,1154,6969
56,27,56027,Wyoming,Niobrara County,1030,1202,13,8,3,9,48,47,2232,6,26,95
56,29,56029,Wyoming,Park County,13943,14066,134,95,89,145,832,774,28009,178,268,1606
56,31,56031,Wyoming,Platte County,4032,3987,31,21,31,32,407,298,8019,62,62,705
56,33,56033,Wyoming,Sheridan County,14515,14457,158,114,104,171,665,675,28972,208,316,1340
56,35,56035,Wyoming,Sublette County,5023,4370,55,32,36,38,378,324,9393,72,110,702
56,37,56037,Wyoming,Sweetwater County,20446,19252,347,251,203,250,3551,3221,39698,406,694,6772
56,39,56039,Wyoming,Teton County,11567,10718,101,71,143,252,1884,1670,22285,286,202,3554
56,41,56041,Wyoming,Uinta County,9753,9524,77,75,38,62,927,944,19277,76,154,1871
56,43,56043,Wyoming,Washakie County,3759,3618,25,19,25,39,565,543,7377,50,50,1108
56,45,56045,Wyoming,Weston County,3392,3062,32,16,34,83,155,130,6454,68,64,285
